[level]
tileset = tiles32x32.bmp
map = a47a47a47a47a47a47a47a47a47a47a47a47a47a47a47a47a47a47a47a47a47a47a47a47a47a47a47a47a47a47
	  a47a47a47a47a47a47a47a47a47a47a47a47a47a47a47a47a47a47a47a47a47a47a47a47a47a47a47a47a47a47
	  a47a47a09a09a09a09a09a09a09a47a47a09a09a09a09a09a09a09a09a47a47a09a09a09a09a09a09a09a47a47
	  a47a47a09a09a09a09a09a09a09a47a47a09a09a09a09a09a09a09a09a47a47a09a09a09a09a09a09a09a47a47
	  a47a47a09a09a09a09a09a09a09a47a47a09a09a09a09a09a09a09a09a47a47a09a09a47a47a09a09a09a47a47
	  a47a47a09a09a09a09a09a09a09a47a47a09a09a09a09a09a09a09a09a47a47a09a09a47a47a09a09a09a47a47
	  a47a47a09a09a09a09a09a09a09a47a47a09a09a09a09a09a09a09a09a47a47a09a09a47a47a09a09a09a47a47
	  a47a47a09a09a09a47a47a09a09a47a47a09a09a09a09a09a09a09a09a47a47a09a09a47a47a09a09a09a47a47
	  a47a47a09a09a09a47a47a09a09a47a47a09a09a09a09a09a09a09a09a47a47a09a09a47a47a09a09a09a47a47
	  a47a47a09a09a09a47a47a09a09a47a47a09a09a09a09a09a09a09a09a47a47a09a09a47a47a09a09a09a47a47
	  a47a47a09a09a09a47a47a09a09a47a47a09a09a09a09a09a09a09a09a47a47a09a09a47a47a09a09a09a47a47
	  a47a47a09a09a09a47a47a09a09a47a47a47a47a47a09a09a47a47a47a47a47a09a09a47a47a09a09a09a47a47
	  a47a47a09a09a09a47a47a09a09a47a47a47a47a47a09a09a47a47a47a47a47a09a09a47a47a09a09a09a47a47
	  a47a47a09a09a09a47a47a09a09a47a47a09a09a09a09a09a09a09a09a47a47a09a09a47a47a09a09a09a47a47
	  a47a47a09a09a09a47a47a09a09a47a47a09a09a09a09a09a09a09a09a47a47a09a09a47a47a09a09a09a47a47
	  a47a47a09a09a09a47a47a09a09a47a47a09a09a09a09a09a09a09a09a09a09a09a09a47a47a09a09a09a47a47
	  a47a47a09a09a09a47a47a09a09a47a47a09a09a09a09a09a09a09a09a09a09a09a09a47a47a09a09a09a47a47
	  a47a47a09a09a09a47a47a09a09a47a47a47a47a47a47a47a47a47a47a47a47a47a47a47a47a09a09a09a47a47
	  a47a47a09a09a09a47a47a09a09a47a47a47a47a47a47a47a47a47a47a47a47a47a47a47a09a09a09a09a47a47
	  a47a47a09a09a09a47a47a09a09a09a09a09a09a09a09a09a09a09a09a09a09a09a09a09a09a09a09a09a47a47
	  a47a47a09a09a09a47a47a09a09a09a09a09a09a09a09a09a09a09a09a09a09a09a09a09a09a09a09a09a47a47
	  a47a47a47a09a09a47a47a47a47a47a47a09a09a47a47a47a47a47a47a47a47a47a47a47a47a47a47a47a47a47
	  a47a47a47a09a09a47a47a47a47a47a47a09a09a47a47a47a47a47a47a47a47a47a47a47a47a47a47a47a47a47
	  a47a47a09a09a09a09a09a09a09a47a47a09a09a09a09a09a09a09a09a09a09a09a09a09a09a09a09a09a47a47
	  a47a47a09a09a09a09a09a09a09a47a47a09a09a09a47a09a47a09a47a09a09a09a09a09a09a09a09a09a47a47
	  a47a47a09a09a47a47a09a09a09a47a47a09a09a47a09a47a09a47a09a47a09a09a47a09a09a47a09a09a47a47
	  a47a47a09a09a47a47a09a09a09a47a47a09a09a09a09a09a09a09a09a09a09a47a47a09a09a47a09a09a47a47
	  a47a47a09a09a47a47a09a09a09a47a47a47a47a47a47a47a47a47a47a47a47a47a47a09a09a47a09a09a47a47
	  a47a47a09a09a47a47a09a09a09a47a47a47a47a47a47a47a47a47a47a47a47a47a09a09a09a47a09a09a47a47
	  a47a47a09a09a47a47a09a09a09a47a47a09a09a09a09a09a09a09a09a09a09a09a09a09a09a47a09a09a47a47
	  a47a47a09a09a47a47a09a09a09a47a47a09a09a09a09a09a09a09a09a09a09a09a09a09a09a47a09a09a47a47
	  a47a47a09a09a09a09a09a09a09a47a47a09a09a09a47a47a47a47a47a47a47a47a47a09a09a47a47a47a47a47
	  a47a47a09a09a09a09a09a09a09a47a47a09a09a09a47a47a47a47a47a47a47a47a47a09a09a47a47a47a47a47
	  a47a47a09a09a47a47a09a09a09a09a09a09a09a09a47a47a09a09a09a09a09a09a09a09a09a09a09a09a47a47
	  a47a47a09a09a47a47a09a09a09a09a09a09a09a09a47a47a09a09a09a09a09a09a09a09a09a09a09a09a47a47
	  a47a47a09a09a47a47a09a09a09a09a47a47a47a47a47a47a47a47a47a47a47a47a47a47a47a47a09a09a47a47
	  a47a47a09a09a47a47a09a09a09a47a47a47a47a47a47a47a47a47a47a47a47a47a47a47a47a47a09a09a47a47
	  a47a47a09a09a47a47a47a09a09a09a09a09a09a09a09a09a09a09a09a47a47a47a47a09a09a09a09a09a47a47
	  a47a47a09a09a47a47a47a47a09a09a09a09a09a09a09a09a09a09a09a47a47a47a09a09a09a09a09a09a47a47
	  a47a47a09a09a09a47a47a47a47a47a47a47a47a47a47a47a47a47a47a47a47a09a09a09a47a47a09a09a47a47
	  a47a47a09a09a09a09a47a47a47a47a47a47a47a47a47a47a47a47a47a47a09a09a09a47a47a47a09a09a47a47
	  a47a47a09a09a09a09a09a47a47a47a47a47a47a47a47a47a47a47a47a09a09a09a47a47a47a47a09a09a47a47
	  a47a47a09a09a47a09a09a09a09a09a09a09a09a09a09a09a09a09a09a09a09a47a47a47a47a47a09a09a47a47
	  a47a47a09a09a47a47a09a09a09a09a09a09a09a09a09a09a09a09a09a09a47a47a47a47a47a47a09a09a47a47
	  a47a47a09a09a09a47a47a47a47a47a47a47a47a47a47a47a47a47a47a47a47a47a47a47a47a09a09a09a47a47
	  a47a47a09a09a09a09a47a47a47a47a47a47a47a47a47a47a47a47a47a47a47a47a47a47a09a09a09a47a47a47
	  a47a47a09a09a09a09a09a09a09a09a09a09a09a09a09a09a09a09a09a09a09a09a09a09a09a09a47a47a47a47
	  a47a47a09a09a09a09a09a09a09a09a09a09a09a09a09a09a09a09a09a09a09a09a09a09a09a47a47a47a47a47
	  a47a47a47a47a47a47a47a47a47a47a47a47a47a47a47a47a47a47a47a47a47a47a47a47a47a47a47a47a47a47
	  a47a47a47a47a47a47a47a47a47a47a47a47a47a47a47a47a47a47a47a47a47a47a47a47a47a47a47a47a47a47


enemies =  10:FrostBandit
		   10:IceBeetles
		   10:Skyekraken

enemySpawn = 500:500
			 500:1000
			 1000:500
			 1000:1000

