[level]
tileset = tiles32x32.bmp
map = b12b15b15b15b35b35b35b35b35b35b35b35b35b35b35b35b35b35b35b35b35b35b35b35b35b35b15b15b15b18
	  b13b16b16b16b29b29b29b29b29b29b29b29b29b29b29b29b29b29b29b29b29b29b29b29b29b29b16b16b16b19
	  b13b16b16b16b29b29b29b29b29b29b29b29b29b29b29b29b29b29b29b29b29b29b29b29b29b29b16b16b16b19
	  b13b16b16b16b29b29b29b29b29b29b29b29b29b29b29b29b29b29b29b29b29b29b29b29b29b29b16b16b16b19
	  b33b29b29b29b29b29b29b29b29b29b29b29b29b29b29b29b29b29b29b29b29b29b29b29b29b29b29b29b29b39
	  b33b29b29b29b29b29b29b29b29b29b29b29b29b29b29b29b29b29b29b29b29b29b29b29b29b29b29b29b29b39
	  b33b29b29b29b29b29b29b29b29b29b29b29b29b29b29b29b29b29b29b29b29b29b29b29b29b29b29b29b29b39
	  b33b29b29b29b29b29b29b29b29b29b29b29b29b29b29b29b29b29b29b29b29b29b29b29b29b29b29b29b29b39
	  b33b29b29b29b29b29b29b29b29b29b29b29b29b29b29b29b29b29b29b29b29b29b29b29b29b29b29b29b29b39
	  b33b29b29b29b29b29b29b29b29b29b29b29b29b29b29b29b29b29b29b29b29b29b29b29b29b29b29b29b29b39
	  b33b29b29b29b29b29b29b29b29b29b29b29b29b29b29b29b29b29b29b29b29b29b29b29b29b29b29b29b29b39
	  b33b29b29b29b29b29b29b29b29b29b29b29b29b29b29b29b29b29b29b29b29b29b29b29b29b29b29b29b29b39
	  b33b29b29b29b29b29b29b29b29b29b29b29b29b29b29b29b29b29b29b29b29b29b29b29b29b29b29b29b29b39
	  b33b29b29b29b29b29b29b29b29b29b29b29b29b29b29b29b29b29b29b29b29b29b29b29b29b29b29b29b29b39
	  b33b29b29b29b29b29b29b29b29b29b29b29b29b29b29b29b29b29b29b29b29b29b29b29b29b29b29b29b29b39
	  b33b29b29b29b29b29b29b29b29b29b29b29b29b29b29b29b29b29b29b29b29b29b29b29b29b29b29b29b29b39
	  b33b29b29b29b29b29b29b29b29b29b29b29b29b29b29b29b29b29b29b29b29b29b29b29b29b29b29b29b29b39
	  b33b29b29b29b29b29b29b29b29b29b29b29b29b29b29b29b29b29b29b29b29b29b29b29b29b29b29b29b29b39
	  b33b29b29b29b29b29b29b29b29b29b29b29b29b29b29b29b29b29b29b29b29b29b29b29b29b29b29b29b29b39
	  b33b29b29b29b29b29b29b29b29b29b29b29b29b29b29b29b29b29b29b29b29b29b29b29b29b29b29b29b29b39
	  b33b29b29b29b29b29b29b29b29b29b29b29b29b29b29b29b29b29b29b29b29b29b29b29b29b29b29b29b29b39
	  b33b29b29b29b29b29b29b29b29b29b29b29b29b29b29b29b29b29b29b29b29b29b29b29b29b29b29b29b29b39
	  b33b29b29b29b29b29b29b29b29b29b29b29b29b29b29b29b29b29b29b29b29b29b29b29b29b29b29b29b29b39
	  b33b29b29b29b29b29b29b29b29b29b29b29b29b29b29b29b29b29b29b29b29b29b29b29b29b29b29b29b29b39
	  b33b29b29b29b29b29b29b29b29b29b29b29b29b29b29b29b29b29b29b29b29b29b29b29b29b29b29b29b29b39
	  b33b29b29b29b29b29b29b29b29b29b29b29b29b29b29b29b29b29b29b29b29b29b29b29b29b29b29b29b29b39
	  b13b16b16b16b29b29b29b29b29b29b29b29b29b29b29b29b29b29b29b29b29b29b29b29b29b29b16b16b16b19
	  b13b16b16b16b29b29b29b29b29b29b29b29b29b29b29b29b29b29b29b29b29b29b29b29b29b29b16b16b16b19
	  b13b16b16b16b29b29b29b29b29b29b29b29b29b29b29b29b29b29b29b29b29b29b29b29b29b29b16b16b16b19
	  b14b17b17b17b37b37b37b37b37b37b37b37b37b37b37b37b37b37b37b37b37b37b37b37b37b37b17b17b17b20
	  
	  