[level]
tileset = tiles32x32.bmp
map = a75a75a75a75a75a75a75a75a75a75a75a75a75a75a75a75a75a75a75a75a75a75a75a75a75a75a75a75a75a75a75a75a75a75a75a75a75a75a75a75a75a75a75a75a75a75a75a75a75a75a75a75a75a75a75a75a75a75a75a75a75a75a75a75a75a75a75a75a75a75
	  a75a45a45a45a45a45a45a45a45a45a45a45a45a45a45a45a45a45a45a45a45a45a45a45a45a45a45a45a45a45a45a45a75a45b30b30a45a75a45a45a45a45a45a45a45a45a45a45a45a45a45a45a45a45a45a45a45a45a45a45a45a45a45a45a45a45a45a45a45a75
	  a75a45a45a45a45a45a45a45a45a45a45a45a45a45a45a45a45a45a45a45a45a45a45a45a45a45a45a45a45a45a45a45a75a45b30b30a45a75a45a45a45a45a45a45a45a45a45a45a75a75a75a45a75a75a75a45a75a45a45a45a75a45a45a45a45a45a45a45a45a75
	  a75a45a45a45a45a45a45a43a45a45a45a45a45a43a45a45a45a45a45a45a45a45a43a45a45a45a45a45a45a45a45a45a75a45a45a45a45a75a45a45a45a45a45a45a45a45a45a45a75a45a45a45a75a45a75a45a75a45a75a45a75a45a45a45a45a45a45a45a45a75
	  a75a45a45a45a45a45a45a45a45a45a45a45a45a45a45a45a45a43a45a45a45a45a45a45a45a45a45a45a45a45a45a45a75a45a45a45a45a75a45a45a45a45a45a45a45a45a45a45a75a75a75a45a75a75a75a45a45a75a45a75a45a45a45a45a45a45a45a45a45a75
	  a75a45a45a45a45a45a45a45a45a45a45a45a45a45a45a45a45a45a45a45a45a45a45a45a45a45a45a45a45a45a45a45a45a45a45a45a45a45a45a45a45a45a45a45a45a45a45a45a45a45a45a45a45a45a45a45a45a45a45a45a45a45a45a45a45a45a45a45a45a75
	  a75a45a45a45a45a43a45a45a45a45a45a45a45a45a45a45a45a45a45a45a45a45a45a45a45a45a45a45a45a45a45a45a45a45a45a45a45a45a45a45a45a45a45a45a45a45a45a45a45a45a45a45a45a45a45a45a45a45a45a45a45a45a45a45a45a45a45a45a45a75
	  a75a45a45a45a45a45a45a45a45a45a45a75a75a45a45a45a45a45a45a45a45a45a45a45a45a45a45a45a45a45a45a45a45a45a45a45a45a45a45a45a45a45a45a36a45a45a45a45a45a45a45a45a45a45a45a45a45a45a45a45a45a45a45a45a45a45a45a45a45a75
	  a75a45a45a45a45a45a45a45a45a45a45a75a75a45a45a45a45a45a45a45a45a45a45a45a45a45a45a45a45a45a45a45a45a45a45a45a45a45a45a45a45a36a45a45a45a45a45a45a45a45a45a45a45a45a45a45a45a45a45a45a45a45a45a45a45a45a45a45a45a75
	  a75a45a45a45a45a45a45a45a43a45a45a75a75a45a45a45a45a45a45a45a45a45a45a45a45a45a45a45a45a45a45a45a45a45a45a45a45a45a45a45a45a45a45a45a45a45a45a45a45a45a45a45a45a45a45a45a45a45a45a45a45a45a45a45a45a45a45a45a45a75
	  a75a43a45a45a45a45a45a45a45a45a45a75a75a45a45a45a45a45a45a45a45a45a45a45a45a45a45a45a45a45a45a45a45a45a36a45a45a45a45a45a45a45a45a45a45a45a45a45a45a45a45a45a45a45a36a45a45a45a45a45a45a45a45a45a45a45a45a45a45a75
	  a75a45a45a45a45a45a45a45a45a45a45a75a75a75a45a45a45a45a45a45a45a45a45a45a45a45a45a45a45a45a45a45a45a45a45a45a45a45a45a45a45a45a45a45a45a45a45a45a45a45a45a45a45a45a45a45a45a45a45a45a45a45a45a45a45a45a45a45a45a75
	  a75a45a45a45a45a45a45a45a45a45a45a45a75a75a45a45a45a45a45a45a45a45a45a45a45a45a45a45a45a45a45a45a45a45a45a45a45a45a45a45a45a45a45a45a45a45a45a45a45a45a45a45a45a45a45a45a45a45a45a45a45a45a45a45a45a45a45a45a45a75
	  a75a45a45a45a45a45a45a45a45a45a45a45a45a45a45a45a45a45a45a45a45a45a45a45a45a45a45a45a45a45a45a45a45a45a45a45a45a45a45a45a45a45a45a36a45a75a75a45a45a45a45a45a45a45a45a45a45a36a45a45a45a45a45a45a45a45a45a45a45a75
	  a75a45a45a45a45a45a45a43a45a45a45a45a45a45a45a45a45a45a45a45a45a45a45a45a45a45a45a45a45a45a45a45a45a45a45a45a45a45a45a45a45a45a45a45a45a75a75a75a75a45a45a45a45a45a45a45a45a45a45a45a45a45a45a45a45a45a45a45a45a75
	  a75a45a45a45a45a45a45a45a45a45a45a45a45a45a45a45a45a45a45a45a45a45a45a45a45a45a45a45a45a45a45a45a45a45a45a45a45a45a45a45a45a45a45a45a45a75a75a75a75a45a45a45a45a45a45a45a45a45a45a45a45a45a45a45a45a45a45a45a45a75
	  a75a45a45a45a43a45a45a45a45a45a45a45a45a45a45a45a45a45a45a45a45a45a45a45a45a75a45a45a75a45a45a45a45a45a45a45a36a45a45a45a45a45a45a45a45a45a45a45a45a45a45a45a45a45a45a45a45a45a45a45a45a45a45a45a45a45a45a45a45a75
	  a75a45a45a45a45a45a45a45a45a45a45a45a45a43a45a45a45a45a45a45a45a45a45a45a45a75a45a45a75a45a45a45a45a45a45a45a45a45a45a45a45a45a45a45a45a45a45a45a45a45a45a45a45a45a45a45a45a45a45a45a45a45a45a45a45a45a45a45a45a75
	  a75a45a45a45a45a45a45a45a45a45a45a45a45a45a45a45a45a45a45a45a45a45a45a45a45a45a45a45a45a45a45a45a45a36a45a45a45a45a45a45a45a45a45a45a45a45a45a45a45a45a45a45a36a45a45a45a45a45a45a45a45a45a45a45a45a45a45a45a45a75
	  a75a45a45a45a45a45a45a45a45a45a45a45a45a45a45a45a45a43a45a45a45a45a45a45a75a45a45a45a45a75a45a45a45a45a45a45a45a45a45a45a45a45a45a45a45a45a45a45a45a45a45a45a45a45a45a45a45a45a45a45a45a45a45a45a45a45a45a45a45a75
	  a75a45a45a45a45a45a45a45a45a45a45a45a45a45a45a45a45a45a45a45a45a45a45a45a45a75a45a45a75a45a45a45a45a45a45a45a45a45a45a45a45a45a45a45a45a45a45a45a45a45a45a45a45a45a45a45a45a45a45a45a45a45a45a45a45a45a45a45a45a75
	  a75a45a45a45a45a45a45a45a45a45a45a45a45a45a45a45a45a45a45a45a45a45a45a45a45a45a75a75a45a45a45a45a45a45a45a45a45a45a45a45a45a45a45a45a45a45a45a45a45a45a45a45a45a45a45a45a45a45a45a45a45a45a45a45a45a45a45a45a45a75
	  a75a45a45a45a43a45a45a45a43a45a45a45a45a45a45a45a45a45a45a45a45a45a45a45a45a45a45a45a45a45a45a45a45a45a45a45a45a45a45a45a45a45a45a45a36a45a45a45a45a45a45a45a45a36a45a45a75a75a75a75a45a45a45a45a45a45a45a45a45a75
	  a75a45a45a45a45a45a45a45a45a45a45a45a45a45a45a45a45a45a45a45a45a45a45a45a45a45a45a45a45a45a45a45a45a45a45a45a45a45a45a45a45a45a45a45a45a45a45a45a45a45a45a45a45a45a45a45a75a75a75a75a45a45a45a45a45a45a45a45a45a75
	  a75a45a45a45a45a45a45a45a45a45a45a45a45a45a45a45a45a45a45a45a45a45a45a45a45a45a45a45a45a45a45a45a45a45a45a45a45a45a45a36a45a45a45a45a45a45a45a45a45a45a45a45a45a45a45a45a45a45a45a45a45a45a45a45a45a45a45a45a45a75
	  a75a45a45a45a45a45a45a45a45a45a45a45a45a45a45a45a45a45a45a45a45a45a45a45a45a45a45a45a45a45a45a45a45a45a45a45a45a45a45a45a45a45a45a45a45a45a45a45a45a45a45a45a45a45a45a45a45a45a45a45a45a45a45a45a45a45a45a45a45a75
	  a75a45a45a45a45a45a45a45a45a45a45a45a45a45a45a43a45a45a45a45a45a45a45a45a45a45a45a45a45a45a45a45a45a45a45a45a45a45a45a45a45a45a45a45a45a45a45a45a45a45a45a45a45a45a45a45a45a45a45a45a45a45a45a45a45a45a45a45a45a75
	  a75a45a45a45a45a45a45a45a45a45a45a45a45a45a45a45a45a45a45a45a45a45a45a45a45a45a45a45a45a45a45a45a36a45a45a45a45a45a45a45a45a45a45a45a45a45a45a45a45a36a45a45a45a45a45a45a45a45a45a45a45a45a45a45a45a45a45a45a45a75
	  a75a45a45a45a45a45a45a45a45a45a45a45a45a45a45a45a45a45a45a45a45a45a45a45a45a45a45a45a45a45a45a45a45a45a45a45a45a45a45a45a45a36a45a45a45a45a45a45a45a45a45a45a45a45a45a45a45a45a45a45a45a45a45a45a45a45a45a45a45a75
	  a75a45a45a45a45a45a45a45a45a45a45a45a45a45a45a45a45a45a45a45a45a45a45a45a45a45a45a45a45a45a45a45a45a45a45a45a45a45a45a45a45a45a45a45a45a45a45a45a45a45a45a45a45a45a45a45a45a36a45a45a45a45a45a45a45a45a45a45a45a75
	  a75a45a45a45a45a45a45a43a45a45a45a45a45a45a45a45a45a45a45a45a45a45a45a45a45a45a45a45a45a45a45a45a45a45a45a45a45a36a45a45a45a45a45a45a45a45a45a45a45a45a45a45a45a45a45a45a45a45a45a45a45a45a45a45a45a45a45a45a45a75
	  a75a45a45a45a45a45a45a45a45a45a45a45a45a45a45a45a45a45a45a45a45a45a45a45a45a45a45a45a45a45a45a45a45a45a45a45a45a45a45a45a45a45a45a45a45a45a45a45a45a45a45a45a45a45a45a45a45a45a45a45a45a36a45a45a45a45a45a45a45a75
	  a75a45a45a45a45a45a45a45a45a45a45a45a45a45a45a45a45a45a45a45a45a45a45a45a45a45a45a45a45a45a45a45a45a45a45a45a45a45a45a45a45a45a45a45a45a45a45a45a45a45a45a45a45a45a45a45a45a45a45a45a45a45a45a45a45a45a45a45a45a75
	  a75a45a45a45a43a45a45a45a45a45a45a45a45a45a45a45a45a45a45a45a45a45a45a45a45a45a45a45a45a45a45a45a36a45a45a45a45a45a45a45a45a45a45a45a45a45a45a45a45a45a45a45a45a45a45a45a45a45a45a45a45a45a45a45a45a45a45a45a45a75
	  a75a45a45a45a45a45a45a45a45a45a45a45a45a45a45a45a45a45a45a45a45a45a45a45a45a45a45a45a45a45a45a45a45a45a45a45a45a36a45a45a45a45a45a45a45a45a45a45a45a45a45a45a45a45a45a45a45a45a45a45a45a45a45a45a45a45a45a45a45a75
	  a75a45a45a45a45a45a45a45a45a45a45a45a45a45a45a45a45a45a45a45a45a45a45a45a45a45a45a45a45a45a45a45a45a45a45a45a45a45a45a45a45a45a45a36a45a45a45a45a45a36a45a45a45a45a45a45a45a45a36a45a45a45a45a45a45a45a45a45a45a75
	  a75a45a45a45a45a45a45a45a45a45a45a45a45a45a45a43a45a45a45a45a45a45a45a45a45a45a45a45a45a45a45a45a45a45a45a45a45a45a45a45a45a45a45a45a45a45a45a45a45a45a45a45a45a45a45a45a45a45a45a45a45a45a45a45a45a45a45a45a45a75
	  a75a45a45a45a45a45a45a45a45a45a45a45a45a45a45a45a45a45a45a45a45a45a45a45a45a45a45a45a45a45a45a45a45a45a45a45a45a45a45a45a45a45a45a45a45a45a45a45a45a45a45a45a45a45a45a45a45a45a45a45a45a45a45a45a45a45a45a45a45a75
	  a75a45a45a45a45a45a45a43a45a45a45a45a45a45a45a45a45a45a45a45a45a45a45a45a45a45a45a45a45a45a45a45a45a45a45a45a36a45a45a45a45a45a45a45a45a45a45a45a45a45a45a45a45a45a45a45a45a45a45a45a45a45a45a45a45a45a45a45a45a75
	  a75a45a45a45a45a45a45a45a45a45a45a45a45a45a45a45a45a45a45a45a45a45a45a45a45a45a45a45a45a45a45a45a45a45a45a45a45a45a45a45a45a45a45a45a45a45a45a45a75a45a45a45a45a45a45a45a45a36a45a45a45a45a45a45a45a45a45a45a45a75
	  a75a45a45a45a45a45a45a45a45a45a45a45a45a45a45a45a45a45a45a45a45a45a45a45a45a45a45a45a45a45a45a45a45a45a45a45a45a45a45a45a45a45a45a36a45a45a45a45a75a45a45a45a45a45a45a45a45a45a45a45a45a45a36a45a45a45a45a45a45a75
	  a75a45a45a45a45a45a45a45a45a45a45a45a45a45a45a45a45a45a45a45a45a45a45a45a45a45a45a45a45a45a45a45a45a45a45a45a45a45a45a45a45a36a45a45a45a45a45a45a75a45a45a45a45a45a45a45a45a45a45a45a45a45a45a45a45a45a45a45a45a75
	  a75a45a45a45a45a75a75a75a75a75a75a75a75a75a45a45a45a45a45a45a45a45a45a45a45a45a45a45a45a45a45a45a45a45a45a45a45a45a45a45a45a45a45a45a45a45a45a45a45a45a45a45a45a45a45a45a45a45a45a45a45a45a45a45a45a45a45a45a45a75
	  a75a45a45a45a45a75a75a75a75a75a75a75a75a75a75a75a75a75a75a75a45a45a45a45a45a45a45a45a45a45a45a45a36a45a45a45a45a45a45a45a45a45a45a45a45a45a45a45a45a45a45a45a45a45a45a45a45a45a45a45a45a45a45a45a45a45a45a45a45a75
	  a75a45a45a45a45a45a45a45a45a45a45a45a75a75a75a75a75a75a75a75a45a45a45a45a45a45a45a45a45a45a45a45a45a45a45a45a45a45a45a45a45a45a45a45a45a45a45a45a45a45a45a45a45a45a45a45a36a45a45a45a45a45a45a45a45a45a45a45a45a75
	  a75a45a45a45a45a45a45a45a45a45a45a45a45a45a45a45a45a45a75a75a45a45a45a45a45a45a45a45a45a45a45a45a45a45a45a45a45a45a45a45a36a45a45a45a45a45a45a45a45a45a45a36a45a45a45a45a45a45a45a45a45a45a45a45a45a45a45a45a45a75
	  a75a45a45a45a45a45a45a45a45a43a45a45a45a45a45a45a45a45a75a75a45a45a45a45a45a45a45a45a45a45a45a45a45a45a45a45a45a45a45a45a45a45a45a45a45a45a45a45a45a45a45a45a45a45a45a45a45a45a45a45a45a45a45a45a45a45a45a45a45a75
	  a75a45a45a45a45a45a45a45a45a45a45a45a45a45a45a45a45a45a75a75a45a45a45a45a45a45a45a45a45a45a45a45a45a36a45a45a45a45a45a45a45a45a45a45a45a45a45a45a45a45a45a45a45a45a45a45a45a45a45a45a36a45a45a45a45a45a45a45a45a75
	  a75a45a45a45a45a45a45a45a45a45a45a45a45a45a45a45a45a45a75a75a45a45a45a45a45a45a45a45a45a45a45a45a45a45a45a45a45a45a45a45a45a45a45a45a45a45a45a45a45a45a45a45a45a45a45a45a45a45a45a45a45a45a45a45a45a45a45a45a45a75
	  a75a45a45a45a43a45a45a45a45a45a45a45a45a45a45a45a45a45a75a75a45a45a45a45a45a45a45a45a45a45a45a45a45a45a45a45a45a45a45a45a36a45a45a45a45a45a45a45a45a45a45a45a45a45a45a45a45a45a45a45a45a45a45a45a45a45a45a45a45a75
	  a75a45a45a45a45a45a45a45a45a45a45a45a45a45a45a45a45a45a75a75a45a45a45a45a45a45a45a45a45a45a45a45a45a45a45a45a45a45a45a45a45a45a45a45a45a45a45a45a45a45a45a45a45a45a45a45a45a45a45a45a45a45a45a45a45a45a45a45a45a75
	  a75a45a45a45a45a45a45a45a45a45a45a45a45a45a75a75a75a75a75a75a75a75a45a45a45a45a45a45a45a45a45a45a45a45a45a45a45a45a45a45a45a45a45a45a45a45a45a45a45a36a45a45a45a45a45a45a45a45a45a45a45a45a45a45a45a45a45a45a45a75
	  a75a45a45a45a45a45a45a45a45a45a45a45a43a45a75a75a75a75a75a75a75a75a45a45a45a45a45a45a45a45a45a45a36a45a45a45a45a45a45a45a45a45a45a45a45a45a45a45a45a45a45a45a45a45a45a45a45a45a45a45a45a45a45a45a45a45a45a45a45a75
	  a75a45a45a45a45a45a45a45a45a45a45a45a45a45a75a75a75a75a75a75a75a75a45a45a45a45a45a45a45a45a45a45a45a45a45a45a45a45a45a45a45a45a45a45a45a45a36a45a45a45a45a45a45a45a45a45a45a45a75a75a45a45a45a45a45a45a45a45a45a75
	  a75a45a45a45a45a45a45a45a45a45a45a45a45a45a75a75a75b30b30a75a75a75a45a45a45a45a45a45a45a45a45a45a45a45a45a45a45a45a45a45a45a45a45a45a45a45a45a45a45a45a45a45a45a45a45a45a45a45a75a75a45a45a45a45a45a45a45a45a45a75
	  a75a45a45a45a45a45a43a45a45a45a45a45a45a45a75a75a45a45a45a45a75a75a45a45a45a45a45a45a45a45a45a45a45a45a45a45a45a45a45a36a45a45a45a45a45a45a45a45a45a45a45a45a45a36a45a45a45a45a75a75a45a45a45a45a45a45a45a45a45a75
	  a75a45a45a45a45a45a45a45a45a45a45a45a45a45a75a75a45a45a45a45a75a75a45a45a45a45a45a45a45a45a45a45a45a45a45a45a45a45a45a45a45a45a45a45a45a45a45a45a45a45a45a45a45a45a45a45a45a45a45a45a45a45a45a45a45a45a45a45a45a75
	  a75a45a45a45a45a45a45a45a45a45a45a45a45a45a45a45a45a43a45a45a75a75a45a45a45a45a45a45a45a45a45a45a45a45a45a45a45a45a45a45a45a45a45a45a45a45a45a45a45a45a45a45a45a45a45a45a45a45a45a45a45a45a45a45a45a45a45a45a45a75
	  a75a45a45a45a45a45a45a45a45a45a45a45a45a45a45a45a45a45a45a45a75a75a45a45a45a45a45a45a45a45a45a45a36a45a45a45a45a45a45a45a45a45a45a45a45a45a45a45a45a45a45a45a45a45a45a45a45a45a45a45a45a45a45a45a45a45a45a45a45a75
	  a75a75a75a75a75a75a75a75a75a75a75a75a75a75a75a75a75a75a75a75a75a75a45a45a45a45a45a45a45a45a45a45a45a45a45a45a45a45a45a45a75a75a75a45a45a45a45a45a36a45a45a45a45a45a45a45a45a45a45a45a45a45a45a45a45a45a45a45a45a75
	  a75a75a75a75a75a75a75a75a75a75a75a75a75a75a75a75a75a75a75a75a75a75a45a45a45a45a45a45a45a45a45a45a45a45a45a45a45a45a45a45a75a75a75a45a45a45a45a45a45a45a45a45a45a45a45a45a45a45a36a45a45a45a45a45a45a45a45a45a45a75
	  a75a45a45a45a45a45a45a45a45a45a45a45a45a45a45a45a45a45a45a45a45a45a45a45a45a45a45a45a45a45a45a45a45a45a45a45a45a45a45a45a45a45a45a45a45a45a45a45a45a45a45a45a45a45a45a45a45a45a45a45a45a36a45a45a45a45a45a45a45a75
	  a75a45a45a45a45a45a45a45a45a45a45a45a45a45a45a45a45a45a45a45a45a45a45a45a45a45a45a45a45a45a45a45a45a45a45a36a45a45a45a45a45a45a45a45a45a45a45a45a45a45a45a45a45a45a45a45a45a45a45a45a45a45a45a45a45a45a45a45a45a75
	  a75a45a45a45a45a45a45a45a45a45a45a45a45a45a45a45a45a45a45a45a45a45a45a45a45a45a45a45a45a45a45a45a45a45a45a45a45a45a45a45a45a45a45a45a45a45a36a45a45a45a45a45a45a45a45a45a45a45a45a45a45a45a45a45a45a45a45a45a45a75
	  a75a45a45a45a45a45a45a45a45a43a45a45a45a45a45a45a45a45a45a45a43a45a45a45a45a45a45a45a45a45a45a45a45a45a45a45a45a45a45a45a45a36a45a45a45a45a45a45a45a45a45a45a45a45a45a45a45a45a45a45a45a45a45a45a45a45a45a45a45a75
	  a75a45a45a45a45a45a45a45a45a45a45a45a45a45a45a45a45a45a45a45a45a45a45a45a45a45a45a45a45a45a45a45a45a45a45a45a45a45a45a45a45a45a45a45a45a45a45a45a45a36a45a45a45a45a45a45a36a45a45a45a45a45a45a45a45a45a45a45a45a75
	  a75a45a45a45a45a45a45a45a45a45a45a45a45a45a45a45a45a45a45a45a45a45a45a43a45a45a45a45a45a45a45a36a45a45a45a45a45a45a45a45a45a45a45a45a45a45a45a45a45a45a45a45a45a45a45a45a45a45a45a45a45a45a45a45a45a45a45a45a45a75
	  a75a45a45a45a45a45a45a45a45a45a45a45a45a45a45a45a45a45a45a45a45a45a45a45a45a45a45a45a45a45a45a45a45a45a45a45a45a45a45a45a45a45a45a45a45a45a36a45a45a45a45a45a45a45a45a45a45a45a45a45a45a45a45a45a45a45a45a45a45a75
	  a75a45a45a45a45a45a45a45a45a45a45a45a45a45a45a45a45a45a45a45a45a45a45a45a45a45a45a45a45a45a45a45a45a45a45a45a45a45a45a45a45a45a45a45a45a45a45a45a45a45a45a45a45a45a45a45a45a45a45a45a45a45a45a45a45a45a45a45a45a75
	  a75a75a75a75a75a75a75a75a75a75a75a75a75a75a75a75a75a75a75a75a75a75a75a75a75a75a75a75a75a75a75a75a75a75a75a75a75a75a75a75a75a75a75a75a75a75a75a75a75a75a75a75a75a75a75a75a75a75a75a75a75a75a75a75a75a75a75a75a75a75
	  
	  warps = 1:34:hub.map:512:300
			  2:34:hub.map:512:300
			  1:35:hub.map:512:300
			  2:35:hub.map:512:300
			  54:17:mine.map:1184:4672
			  54:18:mine.map:1184:4672
