[level]
tileset = tiles32x32.bmp
map = a48a51a51a51a51a51a51a51a51a51a51a51a51a51a51a51a51a51a51a51a51a51a51a51a51a51a51a51a51a51a51a51a51a51a51a51a51a51a51a51a51a51a51a51a51a51a51a51a51a54
	  a49a18a18a18a18a18a18a18a18a18a18a18a18a18a18a18a18a18a18a18a18a66a18a18a18a18a18a18a18a18a18a18a18a18a18a18a18a18a18a18a18a18a18a18a18a18a18a18a18a55
	  a49a18a18a18a18a18a18a18a18a18a18a18a18a18a18a18a18a18a18a18a18a18a18a18a18a18a18a18a18a18a18a18a18a18a18a18a18a18a18a18a18a18a18a18a18a18a18a18a18a55
	  a49a18a18a18a02a18a18a18a02a02a02a18a02a18a18a18a02a18a02a02a02a18a02a18a18a18a02a02a02a18a18a18a18a18a18a18a18a18a18a18a18a18a18a18a18a18a18a18a18a55
	  a49a18a18a18a02a18a18a18a02a18a18a18a02a18a18a18a02a18a02a18a18a18a02a18a18a18a18a18a02a18a18a18a18a18a18a18a18a18a18a18a18a18a18a18a18a18a18a18a18a55
	  a49a18a18a18a02a18a18a18a02a02a18a18a18a02a18a02a18a18a02a02a18a18a02a18a18a18a18a02a02a18a18a18a18a18a18a18a18a18a18a18a18a18a18a18a18a18a18a18a18a55
	  a49a18a18a18a02a18a18a18a02a18a18a18a18a02a18a02a18a18a02a18a18a18a02a18a18a18a18a18a02a18a18a18a18a18a18a18a18a18a18a18a18a18a18a18a18a18a18a18a18a55
	  a49a18a18a18a02a02a02a18a02a02a02a18a18a18a02a18a18a18a02a02a02a18a02a02a02a18a02a02a02a18a18a18a18a18a18a18a18a18a18a18a18a18a18a18a18a18a18a18a18a55
	  a49a18a18a18a18a18a18a18a18a18a18a18a18a18a18a18a18a18a18a18a18a18a18a18a18a18a18a18a18a18a18a18a18a18a18a18a18a18a18a18a18a18a18a18a18a18a18a18a18a55
	  a49a18a18a18a18a18a18a18a18a18a18a18a18a18a18a18a18a18a18a18a18a18a18a18a18a18a18a18a18a18a18a18a18a18a18a18a18a18a18a18a18a18a18a18a18a18a18a18a18a55
	  a49a18a18a18a18a18a18a18a18a18a18a18a18a18a18a18a18a18a18a18a18a18a18a18a18a18a18a18a18a18a18a18a18a18a18a18a18a18a18a18a18a18a18a18a18a18a18a18a18a55
	  a49a18a18a18a18a18a18a18a18a18a18a18a18a18a18a18a18a18a18a18a18a18a18a18a18a18a18a18a18a18a18a18a18a18a18a18a18a18a18a18a18a18a18a18a18a18a18a18a18a55
	  a49a18a18a18a18a18a18a18a18a18a18a18a18a18a18a18a18a18a18a18a18a18a18a18a18a18a18a18a18a18a18a18a18a18a18a18a18a18a18a18a18a18a18a18a18a18a18a18a66a55
	  a49a18a18a18a18a18a18a18a18a18a18a18a18a18a18a18a18a18a18a18a18a18a18a18a18a18a18a18a18a18a18a18a18a18a18a18a18a18a18a18a18a18a18a18a18a18a18a18a18a55
	  a49a18a18a18a18a18a18a18a18a18a18a18a18a18a18a18a18a18a18a18a18a18a18a18a18a18a18a18a18a18a18a18a18a18a18a18a18a18a18a18a18a18a18a18a18a18a18a18a18a55
	  a49a18a18a18a18a18a18a18a18a18a18a18a18a18a18a18a18a18a18a18a18a18a18a18a18a18a18a18b29b29b29b29b29b29b29a18a18a18a18a18a18a18a18a18a18a18a18a18a18a55
	  a49a18a18a18a18a18a18a18a18a18a18a18a18a18a18a18a18a18a18a18a18a18a18a18a18a18a18a18b29b29b29b29b29b29b29a18a18a18a18a18a18a18a18a18a18a18a18a18a18a55
	  a49a18a18a18a18a18a18a18a18a18a18a18a18a18a18a18a18a18a18a18a18a18a18a18a18a18a18a18b29b29b29b29b29b29b29a18a18a18a18a18a18a18a18a18a18a18a18a18a18a55
	  a49a18a18a18a18a98b04a46a98b04a18a18a18a18a18a18a18a18a18a18a18a18a18a18a18a18a18a18b29b29b29b30b29b29b29a18a18a18a18a18a18a18a18a18a18a18a18a18a18a55
	  a49a18a18a18a18a96a90a46a96b05a18a18a18a18a18a18a18a18a18a18a18a18a18a18a18a18a18a18b29b29b29b29b29b29b29a18a18a18a18a18a18a18a18a18a18a18a18a18a18a55
	  a49a18a18a18a18a96b02b30b02a90a18a18a18a18a18a18a18a18a18a18a18a18a18a18a18a18a18a18b29b29b29b29b29b29b29a18a18a18a18a18a18a18a18a18a18a18a18a18a18a55
	  a49a18a18a18a18b00b03b03b03b06a18a18a18a18a18a18a18a18a18a18a18a18a18a18a18a18a18a18b29b29b29b29b29b29b29a18a18a18a18a18a18a18a18a18a18a18a18a18a18a55
	  a49a18a18a18a18a18a18a18a18a18a18a18a18a18a18a18a18a18a18a18a18a18a18a18a18a18a18a18a18a18a18a18a18a18a18a18a18a18a18a18a18a18a18a18a18a18a18a18a18a55
	  a49a18a18a18a18a18a18a18a18a18a18a18a18a18a18a18a18a18a18a18a18a18a18a18a18a18a18a18a18a18a18a18a18a18a18a18a18a18a18a18a18a18a18a18a18a18a18a18a18a55
	  a49a18a18a18a18a18a18a18a18a18a18a18a18a18a18a18a18a18a18a18a18a18a18a18a18a18a18a18a18a18a18a18a18a18a18a18a18a18a18a18a18a18a18a18a18a18a18a18a18a55
	  a49a18a18a18a18a18a18a18a18a18a18a18a18a18a18a18a18a18a18a18a18a18a18a18a18a18a18a18a18a18a18a18a18a18a18a18a18a18a18a18a18a18a18a18a18a18a18a18a18a55
	  a49a18a18a18a18a18a18a18a18a18a18a18a18a18a18a18a18a18a18a18a18a18a18a18a18a18a18a18a18a18a18a18a18a18a18a18a18a18a18a18a18a18a18a18a18a18a18a18a18a55
	  a49a18a18a18a18a18a18a18a18a18a18a18a18a18a18a18a18a18a18a18a18a18a18a18a18a18a18a18a18a18a18a18a18a18a18a18a18a18a18a18a18a18a18a18a18a18a18a18a18a55
	  a49a18a18a18a18a18a18a18a18a18a18a18a18a18a18a18a18a18a18a18a18a18a18a18a18a18a18a18a18a18a18a18a18a18a18a18a18a18a18a18a18a18a18a18a18a18a18a18a18a55
	  a49a18a18a18a18a18a18a18a18a18a18a18a18a18a18a18a18a18a18a18a18a18a18a18a18a18a18a18a18a18a18a18a18a18a18a18a18a18a18a18a18a18a18a18a18a18a18a18a18a55
	  a49a18a18a18a18a18a18a18a18a18a18a18a18a18a18a18a18a18a18a18a18a18a18a18a18a18a18a18a18a18a18a18a18a18a18a18a18a18a18a18a18a18a18a18a18a18a18a18a18a55
	  a49a18a18a18a18a18a18a18a18a18a18a18a18a18a18a18a18a18a18a18a18a18a18a18a18a18a18a18a18a18a18a18a18a18a18a18a18a18a18a18a18a18a18a18a18a18a18a18a18a55
	  a49a18a18a18a18a18a18a18a18a18a18a18a18a18a18a18a18a18a18a18a18a18a18a18a18a18a18a18a18a18a18a18a18a18a18a18a18a18a18a18a18a18a18a18a18a18a18a18a18a55
	  a49a18a18a18a18a18a18a18a18a18a18a18a18a18a18a18a18a18a18a18a18a18a18a18a18a18a18a18a18a18a18a18a18a18a18a18a18a18a18a18a18a18a18a18a18a18a18a18a18a55
	  a49a18a18a18a18a18a18a18a18a18a18a18a18a18a18a18a18a18a18a18a18a18a18a18a18a18a18a18a18a18a18a18a18a18a18a18a18a18a18a18a18a18a18a18a18a18a18a18a18a55
	  a49a18a18a18a18a18a18a18a18a18a18a18a18a18a18a18a18a18a18a18a18a18a18a18a18a18a18a18a18a18a18a18a18a18a18a18a18a18a18a18a18a18a18a18a18a18a18a18a18a55
	  a49a18a18a18a18a18a18a18a18a18a18a18a18a18a18a18a18a18a18a18a18a18a18a18a18a18a18a18a18a18a18a18a18a18a18a18a18a18a18a18a18a18a18a18a18a18a18a18a18a55
	  a49a18a18a18a18a18a18a18a18a18a18a18a18a18a18a18a18a18a18a18a18a18a18a18a18a18a18a18a18a18a18a18a18a18a18a18a18a18a18a18a18a18a18a18a18a18a18a18a18a55
	  a49a18a18a18a18a18a18a18a18a18a18a18a18a18a18a18a18a18a18a18a18a18a18a18a18a18a18a18a18a18a18a18a18a18a18a18a18a18a18a18a18a18a18a18a18a18a18a18a18a55
	  a49a18a18a18a18a18a18a18a18a18a18a18a18a18a18a18a18a18a18a18a18a18a18a18a18a18a18a18a18a18a18a18a18a18a18a18a18a18a18a18a18a18a18a18a18a18a18a18a18a55
	  a49a18a18a18a18a18a18a18a18a18a18a18a18a18a18a18a18a18a18a18a18a18a18a18a18a18a18a18a18a18a18a18a18a18a18a18a18a18a18a18a18a18a18a18a18a18a18a18a18a55
	  a49a18a18a18a18a18a18a18a18a18a18a18a18a18a18a18a18a18a18a18a18a18a18a18a18a18a18a18a18a18a18a18a18a18a18a18a18a18a18a18a18a18a18a18a18a18a18a18a18a55
	  a49a18a18a18a18a18a18a18a18a18a18a18a18a18a18a18a18a18a18a18a18a18a18a18a18a18a18a18a18a18a18a18a18a18a18a18a18a18a18a18a18a18a18a18a18a18a18a18a18a55
	  a49a18a18a18a18a18a18a18a18a18a18a18a18a18a18a18a18a18a18a18a18a18a18a18a18a18a18a18a18a18a18a18a18a18a18a18a18a18a18a18a18a18a18a18a18a18a18a18a18a55
	  a49a18a18a18a18a18a18a18a18a18a18a18a18a18a18a18a18a18a18a18a18a18a18a18a18a18a18a18a18a18a18a18a18a18a18a18a18a18a18a18a18a18a18a18a18a18a18a18a18a55
	  a49a18a18a18a18a18a18a18a18a18a18a18a18a18a18a18a18a18a18a18a18a18a18a18a18a18a18a18a18a18a18a18a18a18a18a18a18a18a18a18a18a18a18a18a18a18a18a18a18a55
	  a49a18a18a18a18a18a18a18a18a18a18a18a18a18a18a18a18a18a18a18a18a18a18a18a18a18a18a18a18a18a18a18a18a18a18a18a18a18a18a18a18a18a18a18a18a18a18a18a18a55
	  a49a18a18a18a18a18a18a18a18a18a18a18a18a18a18a18a18a18a18a18a18a18a18a18a18a18a18a18a18a18a18a18a18a18a18a18a18a18a18a18a18a18a18a18a18a18a18a18a18a55
	  a49a18a18a18a18a18a18a18a18a18a18a18a18a18a18a18a18a18a18a18a18a18a18a18a18a18a18a18a18a18a18a18a18a18a18a18a18a18a18a18a18a18a18a18a18a18a18a18a18a55
	  a50a53a53a53a53a53a53a53a53a53a53a53a53a53a53a53a53a53a53a53a53a53a53a53a53a53a53a53a53a53a53a53a53a53a53a53a53a53a53a53a53a53a53a53a53a53a53a53a53a56



warps = 31:18:level1.map
        20:7:level2.map


pos = 300:300