[level]
tileset = tiles32x32.bmp
map = a00a00a00a00a00a00a00a00a00a00a00a00a00a00a00a00a00a00a00a00a00a00
	  a00a00a00a00a00a00a00a00a00a00a00a00a00a00a00a00a00a00a00a00a00a00
	  a00a00a00a00a00a00a00a00a00a00a00a00a00a00a00a00a00a00a00a00a00a00
	  a00a00a00a00a00a00a00a00a00a00a00a00a00a00a00a00a00a00a00a00a00a00
	  a75a75a45a45a45a45a45a45a45a45b30b30a45a45a45a45a45a45a45a45a75a75
	  a75a75a45a45a45a45a45a45a45a45a45a45a45a45a45a45a45a45a45a45a75a75
	  a75a75a45a45a45a45a45a45a45a45a45a45a45a45a45a45a45a45a45a45a75a75
	  a75a75a45a45a45a45a45a45a45a45a45a45a45a45a45a45a45a45a45a45a75a75
	  a75a75a75a75a75a75a75a75a75a45a45a45a45a75a75a75a75a75a75a75a75a75
	  a75a75a75a75a75a75a75a75a75a45a45a45a45a75a75a75a75a75a75a75a75a75
	  a75a75a75a75a75a75a75a75a75a45a45a45a45a75a75a75a75a75a75a75a75a75
	  a75a75a75a75a75a75a75a75a75a75a45a45a75a75a75a75a75a75a75a75a75a75
	  a75a75a75a75a75a75a75a75a75a75a45a45a75a75a75a75a75a75a75a75a75a75
	  a75a75a75a75a75a75a75a75a75a75a44a45a75a75a75a75a75a75a75a75a75a75
	  a75a75a75a75a75a75a75a75a75a75a45a45a75a75a75a75a75a75a75a75a75a75
	  a75a75a75a75a75a75a75a75a75a75a45a45a75a75a75a75a75a75a75a75a75a75
	  a75a75a75a75a75a75a75a75a75a75a45a45a75a75a75a75a75a75a75a75a75a75
	  a75a75a75a45a45a45a45a45a45a45a45a45a45a45a45a45a45a45a45a75a75a75
	  a75a75a75a45a45a45a36a45a45a45a45a45a45a45a45a45a44a45a45a75a75a75
	  a75a75a75a45a45a45a45a45a45a45a45a45a45a45a45a45a45a45a45a75a75a75
	  a75a75a75a45a45a45a45a45a45a45a45a45a45a45a45a45a45a45a45a75a75a75
	  a75a75a75a45a45a45a45a45a45a45a45a45a45a45a45a45a45a45a45a75a75a75
	  a75a75a75a45a45a45a45a45a45a45a45a45a45a45a45a45a45a45a45a75a75a75
	  a75a75a75a45a45a44a45a45a45a45a45a45a45a45a45a43a45a45a45a75a75a75
	  a75a75a75a45a45a45a45a45a45a45a45a45a45a45a45a45a45a45a45a75a75a75
	  a75a75a75a45a45a45a45a45a45a45a45a45a45a45a45a45a45a45a45a75a75a75
	  a75a75a75a75a75a75a75a75a75a75a45a44a75a75a75a75a75a75a75a75a75a75
	  a75a75a75a75a75a75a75a75a75a75a45a45a75a75a75a75a75a75a75a75a75a75
	  a75a75a75a75a75a75a75a75a75a75a45a45a75a75a75a75a75a75a75a75a75a75
	  a75a75a75a75a45a45a45a45a45a45a45a45a75a75a75a75a75a75a75a75a75a75
	  a75a75a75a75a45a45a45a44a45a45a45a45a75a75a75a75a75a75a75a75a75a75
	  a75a75a75a75a45a45a75a75a75a75a75a75a75a75a75a75a75a75a75a75a75a75
	  a75a75a75a75a45a45a75a75a75a75a75a75a75a75a75a75a75a75a75a75a75a75
	  a75a75a75a75a45a44a45a45a45a45a45a45a45a45a45a45a45a45a75a75a75a75
	  a75a75a75a75a45a45a45a45a45a45a45a45a45a45a45a45a44a45a75a75a75a75
	  a75a75a75a75a75a75a75a75a75a75a75a75a75a75a75a75a45a45a75a75a75a75
	  a75a75a75a75a75a75a75a75a75a75a75a75a75a75a75a75a45a45a75a75a75a75
	  a75a75a75a75a75a75a75a75a75a75a36a45a45a45a45a45a45a45a75a75a75a75
	  a75a75a75a75a75a75a75a75a75a75a45a45a45a45a45a45a45a43a75a75a75a75
	  a75a75a75a75a75a75a75a75a75a75a45a45a75a75a75a75a75a75a75a75a75a75
	  a75a75a75a75a75a75a75a75a75a75a45a45a75a75a75a75a75a75a75a75a75a75
	  a75a75a75a75a75a75a75a75a75a75a45a45a75a75a75a75a75a75a75a75a75a75
	  a75a75a75a75a75a75a75a75a75a75a45a45a75a75a75a75a75a75a75a75a75a75
	  a75a75a75a75a75a75a75a75a75a75a45a45a75a75a75a75a75a75a75a75a75a75
	  a75a75a75a75a75a75a75a75a75a75a45a45a75a75a75a75a75a75a75a75a75a75
	  a75a75a75a75a75a75a75a75a75a36a45a45a45a75a75a75a75a75a75a75a75a75
	  a75a75a75a75a75a75a75a75a75a45a45a45a45a75a75a75a75a75a75a75a75a75
	  a75a75a75a75a75a75a75a75a75a45a45a45a45a75a75a75a75a75a75a75a75a75
	  a75a75a75a75a75a75a75a75a75a44a45a45a43a75a75a75a75a75a75a75a75a75
	  a75a75a75a75a75a75a75a75a75a75a75a75a75a75a75a75a75a75a75a75a75a75
	  
warps = 4:10:doomschasm.map:960:1280
	4:11:doomschasm.map:960:1280

enemies = 4:Darkknight
	  	  1:Drayt
			
		  
enemySpawn = 320:1152
	         1088:1152
	     	 1600:1152