[level]
tileset = tiles32x32.bmp
map = a47a47a47a47a47a47a47a47a47a47a47a47a47a47a47a47a47a47a47a47a47a47a47a47
	  a47a45a45a45a45a45a45a47a45a45a45a45a45a45a45a45a45a45a45a45a45a45a45a47
	  a47a45a45a45a45a45a45a47a45a45a45a45a45a45a45a45a45a45a45a45a45a45a45a47
	  a47a45a45a45a45a45a45a47a45a45a45a45a45a45a45a45a45a45a45a45a45a45a45a47
	  a47a45a45a45a45a45a45a47a47a47a47a47a47a47a47a45a47a47a47a47a47a47a47a47
	  a47a45a45a45a45a45a45a47a45a45a45a45a45a45a45a45a45a45a45a45a45a45a45a47
	  a47a45a45a45a45a45a45a45a45a45a45a45a45a45a45a45a45a45a45a45a45a45a45a47
	  a47a45a45a45a45a45a45a47a47a47a47a47a45a47a47a47a47a47a45a45a45a45a45a47
	  a47a45a45a45a45a45a45a47a45a45a45a45a45a45a45a45a45a47a45a45a45a45a45a47
	  a47a45a45a45a45a45a45a47a45a45a45a45a45a45a45a45a45a47a45a45a45a45a45a47
	  a47a45a45a45a45a45a45a47a45a45a45a45a45a45a45a45a45a47a45a45a45a45b30a47
	  a47a47a47a47a47a47a47a47a47a47a47a47a47a47a47a47a47a47a47a47a47a47a47a47
	  
warps = 10:22:hub.map:1120:800

overlay =o00:5:5
        o00:20:10
        o01:20:20
        o00:20:90
        o01:20:50 


enemies = 20:Cow
	  	  20:Pig

enemySpawn = 256:384
	     	 1088:192
	     	 960:640

	  