[level]
tileset = tiles32x32.bmp
map = a52a52a52a52a52a52a52a52a52a52a52a52a52a52a52a52a52a52a52a52a52a52a52a52a52
	  a52a52a52a52a52a52a52a52a52a52a52a52a52a52a52a52a52a52a52a52a52a52a52a52a52
	  a52a52a52a52a52a52a52a52a52b27b27b27b28b27b27b27a52a52a52a52a52a52a52a52a52
	  a52a52a52a52a52a52a52a52a52b27b28b27b27b27b28b27a52a52a52a52a52a52a52a52a52
	  a53a53a53a53a53a53a53a53a53b28b27b28b28b27b28b27a53a53a53a53a53a53a53a53a53
	  b08b08b08b08b08b08b08b08b08b27b28b27b27b27b27b27b08b08b08b08b08b08b08b08b08
	  b08b08b08b08b08b08b08b08b08b27b28b27b27b27b27b27b08b08b08b08b08b08b08b08b08
	  b08b08b08b08b08b08b08b08b08b27b28b27b27b27b28b28b08b08b08b08b08b08b08b08b08
	  b08b08b08b08b08b08b08b08b08b27b28b28b28b28b27b27b08b08b08b08b08b08b08b08b08
	  b08b08b08b08b08b08b08b08b08b08b08b28b28b28b08b08b08b08b08b08b08b08b08b08b08
	  b08b08b11b11b11b11b11b11b11b11b11b11b11b11b11b11b11b11b11b11b11b11b11b08b08
	  b08b08b11b11b11b11b11b11b11b11b11b11b11b11b11b11b11b11b11b11b11b11b11b08b08
	  b08b08b11b11b11b11b11b11b11b11b11b11b11b11b11b11b11b11b11b11b11b11b11b08b08
	  b08b08b11b11b11b11b11b11b11b11b11b11b11b11b11b11b11b11b11b11b11b11b11b08b08
	  b08b08b11b11b11b11b11b11b11b11b11b11b11b11b11b11b11b11b11b11b11b11b11b08b08
	  b08b08b11b11b11b11b11b11b11b11b11b11b11b11b11b11b11b11b11b11b11b11b11b08b08
	  b08b08b11b11b11b11b11b11b11b11b11b11b11b11b11b11b11b11b11b11b11b11b11b08b08
	  b08b08b11b11b11b11b11b11b11b11b11b11b11b11b11b11b11b11b11b11b11b11b11b08b08
	  b08b08b11b11b11b11b11b11b11b11b11b11b11b11b11b11b11b11b11b11b11b11b11b08b08
	  b08b08b11b11b11b08b08b08b08b08b08b08b08b08b08b08b08b08b08b08b11b11b11b08b08
	  b08b08b11b11b11b08b08b08b08b08b08b08b08b08b08b08b08b08b08b08b11b11b11b08b08
	  b08b08b11b11b11b08b08b08b08b08b08b08b08b08b08b08b08b08b08b08b11b11b11b08b08
	  b08b08b11b11b11b08b08b08b08b08b08b08b08b08b08b08b08b08b08b08b11b11b11b08b08
	  b08b08b11b11b11b08b08b08b08b08b08b08b08b08b08b08b08b08b08b08b11b11b11b08b08
	  b08b08b11b11b11b11b11b11b11b11b11b11b11b11b11b11b11b11b11b11b11b11b11b08b08
	  b08b08b11b11b11b11b11b11b11b11b11b11b11b11b11b11b11b11b11b11b11b11b11b08b08
	  b08b08b11b11b11b11b11b11b11b11b11b11b11b11b11b11b11b11b11b11b11b11b11b08b08
	  b08b08b11b11b11b11b11b11b11b11b11b11b11b11b11b11b11b11b11b11b11b11b11b08b08
	  b08b08b08b08b08b08b08b08b08b08b08b08b08b11b11b08b08b08b08b08b08b08b08b08b08
	  b08b08b08b08b08b08b08b08b08b08b08b08b08b30b30b08b08b08b08b08b08b08b08b08b08
	  
warps = 29:13:sea.map:192:192
	29:14:sea.map:192:192

enemies = 20:Native
	  	  10:Poisonspider
		  1:Chief
		  1:Stormfire
		  
enemySpawn = 320:832
	         1280:832
	     	 256:1600
			 1344:1600
	     	 832:1088
	     	 832:256