[level]
tileset = tiles32x32.bmp
map = a48a51a51a51a51a51a51a51a51a51a51a51a51a51a51a51a51a51a51a51a51a51a51a51a51a51a51a51a51a51a51a51a51a51a51a51a51a51a51a51a51a51a51a51a51a51a51a51a51a54
	  a49a18a18a18a18a18a18a18a18a18a18a18a18a18a18a18a18a18a18a18a18a66a18a18a18a18a18a18a18a18a18a18a18a18a18a18a18a18a18a18a18a18a18a18a18a18a18a18a18a55
	  a49a18a18a18a18a18a18a18a18a18a18a18a18a18a18a18a18a18a18a18a18a18a18a18a18a18a18a18a18a18a18a18a18a18a18a18a18a18a18a18a18a18a18a18a18a18a18a18a18a55
	  a49a18a18a18a02a18a18a18a02a02a02a18a02a18a18a18a02a18a02a02a02a18a02a18a18a18a02a02a02a18a18a18a18a18a18a18a18a18a18a18a18a18a18a18a18a18a18a18a18a55
	  a49a18a18a18a02a18a18a18a02a18a18a18a02a18a18a18a02a18a02a18a18a18a02a18a18a18a18a18a02a18a18a18a18a18a18a18a18a18a18a18a18a18a18a18a18a18a18a18a18a55
	  a49a18a18a18a02a18a18a18a02a02a18a18a18a02a18a02a18a18a02a02a18a18a02a18a18a18a02a02a02a18a18a18a18a18a18a18a18a18a18a18a18a18a18a18a18a18a18a18a18a55
	  a49a18a18a18a02a18a18a18a02a18a18a18a18a02a18a02a18a18a02a18a18a18a02a18a18a18a02a18a18a18a18a18a18a18a18a18a18a18a18a18a18a18a18a18a18a18a18a18a18a55
	  a49a18a18a18a02a02a02a18a02a02a02a18a18a18a02a18a18a18a02a02a02a18a02a02a02a18a02a02a02a18a18a18a18a18a18a18a18a18a18a18a18a18a18a18a18a18a18a18a18a55
	  a49a18a18a18a18a18a18a18a18a18a18a18a18a18a18a18a18a18a18a18a18a18a18a18a18a18a18a18a18a18a18a18a18a18a18a18a18a18a18a18a18a18a18a18a18a18a18a18a18a55
	  a49a18a18a18a18a18a18a18a18a18a18a18a18a18a18a18a18a18a18a18a18a18a18a18a18a18a18a18a18a18a18a18a18a18a18a18a18a18a18a18a18a18a18a18a18a18a18a18a18a55
	  a49a18a18a18a18a18a18a18a18a18a18a18a18a18a18a18a18a18a18a18a18a18a18a18a18a18a18a18a18a18a18a18a18a18a18a18a18a18a18a18a18a18a18a18a18a18a18a18a18a55
	  a49a18a18a18a18a18a18a18a18a18a18a18a18a18a18a18a18a18a18a18a18a18a18a18a18a18a18a18a18a18a18a18a18a18a18a18a18a18a18a18a18a18a18a18a18a18a18a18a18a55
	  a49a18a18a18a18a18a18a18a18a18a18a18a18a18a18a18a18a18a18a18a18a18a18a18a18a18a18a18a18a18a18a18a18a18a18a18a18a18a18a18a18a18a18a18a18a18a18a18a66a55
	  a49a18a18a18a18a18a18a18a18a18a18a18a18a18a18a18a18a18a18a18a18a18a18a18a18a18a18a18a18a18a18a18a18a18a18a18a18a18a18a18a18a18a18a18a18a18a18a18a18a55
	  a49a18a18a18a18a18a18a18a18a18a18a18a18a18a18a18a18a18a18a18a18a18a18a18a18a18a18a18a18a18a18a18a18a18a18a18a18a18a18a18a18a18a18a18a18a18a18a18a18a55
	  a49a18a18a18a18a18a18a18a18a18a18a18a18a18a18a18a18a18a18a18a18a18a18a18a18a18a18a18a18a18a18a18a18a18a18a18a18a18a18a18a18a18a18a18a18a18a18a18a18a55
	  a49a18a18a18a18a18a18a18a18a18a18a18a18a18a18a18a18a18a18a18a18a18a18a18a18a18a18a18a18a18a18a18a18a18a18a18a18a18a18a18a18a18a18a18a18a18a18a18a18a55
	  a49a18a18a18a18a18a18a18a18a18a18a18a18a18a18a18a18a18a18a18a18a18a18a18a18a18a18a18a18a18a18a18a18a18a18a18a18a18a18a18a18a18a18a18a18a18a18a18a18a55
	  a49a18a18a18a18a98b04a46a98b04a18a18a18a18a18a18a18a18a18a18a18a18a18a18a18a18a18a18a18a18a18a18a18a18a18a18a18a18a18a18a18a18a18a18a18a18a18a18a18a55
	  a49a18a18a18a18a96a90a46a96b05a18a18a18a18a18a18a18a18a18a18a18a18a18a18a18a18a18a18a18a18a18a18a18a18a18a18a18a18a18a18a18a18a18a18a18a18a18a18a18a55
	  a49a18a18a18a18a96b02b30b02a90a18a18a18a18a18a18a18a18a18a18a18a18a18a18a18a18a18a18a18a18a18a18a18a18a18a18a18a18a18a18a18a18a18a18a18a18a18a18a18a55
	  a49a18a18a18a18b00b03b03b03b06a18a18a18a18a18a18a18a18a18a18a18a18a18a18a18a18a18a18a18a18a18a18a18a18a18a18a18a18a18a18a18a18a18a18a18a18a18a18a18a55
	  a49a18a18a18a18a18a18a18a18a18a18a18a18a18a18a18a18a18a18a18a18a18a18a18a18a18a18a18a18a18a18a18a18a18a18a18a18a18a18a18a18a18a18a18a18a18a18a18a18a55
	  a49a18a18a18a18a18a18a18a18a18a18a18a18a18a18a18a18a18a18a18a18a18a18a18a18a18a18a18a18a18a18a18a18a18a18a18a18a18a18a18a18a18a18a18a18a18a18a18a18a55
	  a49a18a18a18a18a18a18a18a18a18a18a18a18a18a18a18a18a18a18a18a18a18a18a18a18a18a18a18a18a18a18a18a18a18a18a18a18a18a18a18a18a18a18a18a18a18a18a18a18a55
	  a49a18a18a18a18a18a18a18a18a18a18a18a18a18a18a18a18a18a18a18a18a18a18a18a18a18a18a18a18a18a18a18a18a18a18a18a18a18a18a18a18a18a18a18a18a18a18a18a18a55
	  a49a18a18a18a18a18a18a18a18a18a18a18a18a18a18a18a18a18a18a18a18a18a18a18a18a18a18a18a18a18a18a18a18a18a18a18a18a18a18a18a18a18a18a18a18a18a18a18a18a55
	  a49a18a18a18a18a18a18a18a18a18a18a18a18a18a18a18a18a18a18a18a18a18a18a18a18a18a18a18a18a18a18a18a18a18a18a18a18a18a18a18a18a18a18a18a18a18a18a18a18a55
	  a49a18a18a18a18a18a18a18a18a18a18a18a18a18a18a18a18a18a18a18a18a18a18a18a18a18a18a18a18a18a18a18a18a18a18a18a18a18a18a18a18a18a18a18a18a18a18a18a18a55
	  a49a18a18a18a18a18a18a18a18a18a18a18a18a18a18a18a18a18a18a18a18a18a18a18a18a18a18a18a18a18a18a18a18a18a18a18a18a18a18a18a18a18a18a18a18a18a18a18a18a55
	  a49a18a18a18a18a18a18a18a18a18a18a18a18a18a18a18a18a18a18a18a18a18a18a18a18a18a18a18a18a18a18a18a18a18a18a18a18a18a18a18a18a18a18a18a18a18a18a18a18a55
	  a49a18a18a18a18a18a18a18a18a18a18a18a18a18a18a18a18a18a18a18a18a18a18a18a18a18a18a18a18a18a18a18a18a18a18a18a18a18a18a18a18a18a18a18a18a18a18a18a18a55
	  a49a18a18a18a18a18a18a18a18a18a18a18a18a18a18a18a18a18a18a18a18a18a18a18a18a18a18a18a18a18a18a18a18a18a18a18a18a18a18a18a18a18a18a18a18a18a18a18a18a55
	  a49a18a18a18a18a18a18a18a18a18a18a18a18a18a18a18a18a18a18a18a18a18a18a18a18a18a18a18a18a18a18a18a18a18a18a18a18a18a18a18a18a18a18a18a18a18a18a18a18a55
	  a49a18a18a18a18a18a18a18a18a18a18a18a18a18a18a18a18a18a18a18a18a18a18a18a18a18a18a18a18a18a18a18a18a18a18a18a18a18a18a18a18a18a18a18a18a18a18a18a18a55
	  a49a18a18a18a18a18a18a18a18a18a18a18a18a18a18a18a18a18a18a18a18a18a18a18a18a18a18a18a18a18a18a18a18a18a18a18a18a18a18a18a18a18a18a18a18a18a18a18a18a55
	  a49a18a18a18a18a18a18a18a18a18a18a18a18a18a18a18a18a18a18a18a18a18a18a18a18a18a18a18a18a18a18a18a18a18a18a18a18a18a18a18a18a18a18a18a18a18a18a18a18a55
	  a49a18a18a18a18a18a18a18a18a18a18a18a18a18a18a18a18a18a18a18a18a18a18a18a18a18a18a18a18a18a18a18a18a18a18a18a18a18a18a18a18a18a18a18a18a18a18a18a18a55
	  a49a18a18a18a18a18a18a18a18a18a18a18a18a18a18a18a18a18a18a18a18a18a18a18a18a18a18a18a18a18a18a18a18a18a18a18a18a18a18a18a18a18a18a18a18a18a18a18a18a55
	  a49a18a18a18a18a18a18a18a18a18a18a18a18a18a18a18a18a18a18a18a18a18a18a18a18a18a18a18a18a18a18a18a18a18a18a18a18a18a18a18a18a18a18a18a18a18a18a18a18a55
	  a49a18a18a18a18a18a18a18a18a18a18a18a18a18a18a18a18a18a18a18a18a18a18a18a18a18a18a18a18a18a18a18a18a18a18a18a18a18a18a18a18a18a18a18a18a18a18a18a18a55
	  a49a18a18a18a18a18a18a18a18a18a18a18a18a18a18a18a18a18a18a18a18a18a18a18a18a18a18a18a18a18a18a18a18a18a18a18a18a18a18a18a18a18a18a18a18a18a18a18a18a55
	  a49a18a18a18a18a18a18a18a18a18a18a18a18a18a18a18a18a18a18a18a18a18a18a18a18a18a18a18a18a18a18a18a18a18a18a18a18a18a18a18a18a18a18a18a18a18a18a18a18a55
	  a49a18a18a18a18a18a18a18a18a18a18a18a18a18a18a18a18a18a18a18a18a18a18a18a18a18a18a18a18a18a18a18a18a18a18a18a18a18a18a18a18a18a18a18a18a18a18a18a18a55
	  a49a18a18a18a18a18a18a18a18a18a18a18a18a18a18a18a18a18a18a18a18a18a18a18a18a18a18a18a18a18a18a18a18a18a18a18a18a18a18a18a18a18a18a18a18a18a18a18a18a55
	  a49a18a18a18a18a18a18a18a18a18a18a18a18a18a18a18a18a18a18a18a18a18a18a18a18a18a18a18a18a18a18a18a18a18a18a18a18a18a18a18a18a18a18a18a18a18a18a18a18a55
	  a49a18a18a18a18a18a18a18a18a18a18a18a18a18a18a18a18a18a18a18a18a18a18a18a18a18a18a18a18a18a18a18a18a18a18a18a18a18a18a18a18a18a18a18a18a18a18a18a18a55
	  a49a18a18a18a18a18a18a18a18a18a18a18a18a18a18a18a18a18a18a18a18a18a18a18a18a18a18a18a18a18a18a18a18a18a18a18a18a18a18a18a18a18a18a18a18a18a18a18a18a55
	  a49a18a18a18a18a18a18a18a18a18a18a18a18a18a18a18a18a18a18a18a18a18a18a18a18a18a18a18a18a18a18a18a18a18a18a18a18a18a18a18a18a18a18a18a18a18a18a18a18a55
	  a50a53a53a53a53a53a53a53a53a53a53a53a53a53a53a53a53a53a53a53a53a53a53a53a53a53a53a53a53a53a53a53a53a53a53a53a53a53a53a53a53a53a53a53a53a53a53a53a53a56



warps = 7:20:level3.map

pos = 300:300

overlay =o00:5:5
        o00:20:10
        o01:20:20
        o00:20:90
        o01:20:50

enemies = 50:Wolf

enemySpawn = 500:500
			 500:1000
			 1000:500
			 1000:1000