[level]
tileset = tiles32x32.bmp
map = b08b08b30b30b08b08b08b08b28b28b46b46b46b46b46b46b46b46b46b46b46b46b46b46b46b46b46b46b46b46b46b46b46b46b46b46b46b46b46b46b46b46b46b46b46b46b46b46b46b46
	  b08b08b11b11b08b08b08b08b27b28b46b46b46b46b46b46b46b46b46b46b46b46b46b46b46b46b46b46b46b46b46b46b46b46b46b46b46b46a53a53a53a53a53a53a53a53b46b46b46b46
	  b08b08b11b11b11b11b08b08b28b27b46b46b46b46b46b46b46b46b54b54b54b54b54b54b54b54b54b54b54b54b54b54b46b46b46b46b46a55b11b11b10b11b11b11b11b11a49b46b46b46
	  b08b08b11b11b11b11b08b08b28b28b46b46b46b46b46b46b46b46b54b54b54b54b54b54b54b54b54b54b54b54b54b54b54b54b54b54b54b54b11b11b11b11b11b11b11b11a49b46b46b46
	  b08b08b11b11b11b11b08b08b28b27b46b46b46b54b54b54b54b54b54b54b54b54b54b54b54b54b54b54b54b54b54b54b54b54b54b54b54b54b11b11b11b11b11b10b11b11a49b46b46b46
	  b08b08b11b11b11b11b08b08b27b28b46b46b46b54b54b54b54b54b54b54b54b54b54b54b54b54b54b54b54b54b54b54b46b46b46b46b46a55b11b09b11b11b11b11b11b11a49b46b46b46
	  b08b08b27b27b27b27b27b27b27b28b46b46b46b54b54b46b46b46b54b54b54b54b54b54b54b54b54b54b54b54b54b54b46b46b46b46b46a55b11b11b11b11b11b11b11b11a49b46b46b46
	  b08b08b28b28b28b28b28b28b28b28b46b46b46b54b54b46b46b46b54b54b54b54b54b54b54b54b54b54b54b54b54b54b46b46b46b46b46b46a51a51a51b54b54a51a51a51b46b46b46b46
	  b46b46b46b54b54b46b46b46b46b46b46b46b46b54b54b46b46b46b54b54b54b54b54b54b54b54b54b54b54b54b54b54b46b46b46b46b46b46b46b46b46b54b54b46b46b46b46b46b46b46
	  b46b46b46b54b54b46b46b46b46b46b46b46b46b54b54b46b46b46b46b46b46b46b46b46b54b54b46b46b46b46b46b46b46b46b46b46b46b46b46b46b46b54b54b46b46b46b46b46b46b46
	  b46b46b46b54b54b46b46b46b46b46b46b46b46b54b54b46b46b46b46b46b46b46b46b46b54b54b46b46b46b46b46b46b46b46b46b46b46b46b46b46b46b54b54b46b46b46b46b46b46b46
	  b46b46b46b54b54b46b46b46b46b46b46b46b46b54b54b46b46b46b46b46b46b46b46b46b54b54b46b46b46b46b46b46b46b46b46b46b46b46b46b46b46b54b54b46b46b46b46b46b46b46
	  b46b46b46b54b54b46b46b46b46b46b46b46b54b54b54b54b54b54b46b46b46b46b46b46b54b54b46b46b46b54b54b54b54b54b54b46b46b46b54b54b54b54b54b54b54b54b46b46b46b46
	  b46b46b46b54b54b46b46b46b46b46b46b46b54b54b54b54b54b54b46b46b46b46b46b46b54b54b46b46b46b54b54b54b54b54b54b46b46b46b54b54b54b54b54b54b54b54b46b46b46b46
	  b46b54b54b54b54b54b54b54b46b46b46b46b54b54b54b54b54b54b54b54b54b46b54b54b54b54b54b54b54b54b54b54b54b54b54b54b54b54b54b54b54b54b54b54b54b54b46b46b46b46
	  b46b54b54b54b54b54b54b54b46b46b46b46b54b54b54b54b54b54b54b54b54b46b54b54b54b54b54b54b54b54b54b54b54b54b54b54b54b54b54b54b54b54b54b54b54b54b46b46b46b46
	  b46b54b54b54b54b54b54b54b46b46b46b46b54b54b54b54b54b54b46b46b46b46b46b46b54b54b46b46b46b54b54b54b54b54b54b46b46b46b54b54b54b54b54b54b54b54b46b46b46b46
	  b46b54b54b54b54b54b54b54b46b46b46b46b54b54b54b54b54b54b46b46b46b46b46b46b54b54b46b46b46b54b54b54b54b54b54b46b46b46b54b54b54b54b54b54b54b54b46b46b46b46
	  b46b54b54b54b54b54b54b54b46b46b46b46b46b46b54b54b46b46b46b46b46b46b46b46b54b54b46b46b46b46b46b46b46b46b46b46b46b46b46b46b46b54b54b46b46b46b46b46b46b46
	  b46b54b54b54b54b54b54b54b46b46b46b46b46b46b54b54b46b46b46b46b46b46b46b46b54b54b46b46b46b46b46b46b46b46b46b46b46b46b46b46b46b54b54b46b46b46b46b46b46b46
	  b46b54b54b46b46b46b46b46b46b46b46b46b46b46b54b54b46b46b46b46b46b46b46b46b54b54b46b46b46b46b46b46b46b46b46b46b46b46b46b46b46b54b54b46b46b46b46b46b46b46
	  b46b54b54b46b46b46b46b46b54b54b54b54b54b54b54b54b46b46b46b46b46b46b46b46b54b54b46b46b46b46b46b46b46b46b46b46b46b46b46b46b46b54b54b46b46b46b46b46b46b46
	  b46b54b54b46b46b46b46b46b54b54b54b54b54b54b54b54b46b46b46b46b46b46b46b46b54b54b46b46b46b54b54b54b54b54b54b54b46b46b54b54b54b54b54b54b54b54b46b46b46b46
	  b46b54b54b54b54b46b54b54b54b54b54b54b54b54b54b54b46b46b46b46b46b46b46b46b54b54b46b46b46b54b54b54b54b54b54b54b46b46b54b54b54b54b54b54b54b54b46b46b46b46
	  b46b54b54b54b54b46b54b54b54b54b54b54b54b54b54b54b46b46b46b46b46b46b54b54b54b54b54b54b54b54b54b54b54b54b54b54b54b54b54b54b54b54b54b54b54b54b46b46b46b46
	  b46b54b54b46b46b46b46b46b54b54b54b54b54b54b54b54b46b46b46b46b46b46b54b54b54b54b54b54b54b54b54b54b54b54b54b54b54b54b54b54b54b54b54b54b54b54b46b46b46b46
	  b46b54b54b46b46b46b46b46b54b54b54b54b54b54b54b54b46b46b46b46b46b46b54b54b46b46b46b46b46b54b54b54b54b54b54b54b46b46b54b54b54b54b54b54b54b54b46b46b46b46
	  b46b54b54b46b46b46b46b46b54b54b54b54b54b54b54b54b46b46b46b46b46b46b54b54b46b46b46b46b46b54b54b54b54b54b54b54b46b46b54b54b54b54b54b54b54b54b46b46b46b46
	  b46b54b54b46b46b46b46b46b46b46b46b46b46b54b54b46b46b46b46b46b46b46b54b54b46b46b46b46b46b46b46b46b54b54b46b46b46b46b46b46b46b54b54b46b46b46b46b46b46b46
	  b46b54b54b54b54b46b46b46b46b46b46b46b46b54b54b46b46b46b46b46b46b46b54b54b46b46b46b46b46b46b46b46b54b54b46b46b46b46b46b46b46b54b54b46b46b46b46b46b46b46
	  b46b54b54b54b54b46b46b46b46b46b46b46b46b54b54b46b46b46b46b46b46b46b54b54b46b46b46b46b46b46b46b46b46b46b46b46b46b46b46b46b46b54b54b46b46b46b46b46b46b46
	  b46b46b46b54b54b46b46b46b46b46b46b46b46b54b54b46b46b46b46b46b46b46b54b54b46b46b46b46b46b46b46b46b54b54b46b46b46b46b46b46b46b54b54b46b46b46b46b46b46b46
	  b46b46b46b54b54b46b46b46b46b46b46b46b46b54b54b46b46b46b46b46b46b54b54b54b54b54b54b54b54b46b46b46b54b54b46b46b46b46b54b54b54b54b54b54b54b54b46b46b46b46
	  b46b46b46b54b54b46b46b46b46b46b46b46b46b54b54b46b46b46b46b46b46b54b54b54b54b54b54b54b54b46b46b46b54b54b46b46b46b46b54b54b54b54b54b54b54b54b46b46b46b46
	  b46b54b54b54b54b54b54b54b54b54b54b54b54b54b54b54b54b46b46b46b46b54b54b54b54b54b54b54b54b54b54b54b54b54b54b54b54b54b54b54b54b54b54b54b54b54b46b46b46b46
	  b46b54b54b54b54b54b54b54b54b54b54b54b54b54b54b54b54b46b46b46b46b54b54b54b54b54b54b54b54b54b54b54b54b54b54b54b54b54b54b54b54b54b54b54b54b54b46b46b46b46
	  b46b54b54b54b54b54b54b54b54b54b54b54b54b54b54b54b54b46b46b46b46b54b54b54b54b54b54b54b54b46b46b46b46b46b46b46b46b46b54b54b54b54b54b54b54b54b46b46b46b46
	  b46b54b54b54b54b54b54b54b54b54b54b54b54b54b54b54b54b46b46b46b46b54b54b54b54b54b54b54b54b46b46b46b46b46b46b46b46b46b54b54b54b54b54b54b54b54b46b46b46b46
	  b46b54b54b54b54b54b54b54b54b54b54b54b54b54b54b54b54b46b46b46b46b46b46b46b54b54b46b46b46b46b46b46b46b46b46b46b46b46b46b46b46b46b46b46b46b46b46b46b46b46
	  b46b54b54b54b54b54b54b54b54b54b54b54b54b54b54b54b54b46b46b46b46b46b46b46b54b54b46b46b46b46b46b46b46b46b46b46b46b46b46b46b46b46b46b46b46b46b46b46b46b46
	  b46b54b54b54b54b54b54b54b54b54b54b54b54b54b54b54b54b46b46b46b46b46b46b46b54b54b46b46b46b46b46b46b46b46b46b46b46b46b46b46b46b46b46b46b46b46b46b46b46b46
	  b46b46b46b46b46b46b46b46b46b46b46b46b46b46b46b46b46b46b46b46b46b46b46b46b54b54b46b46b46b46b46b46b46b46b46b46b46b46b46b46b46b46b46b46b46b46b46b46b46b46
	  b46b46b46b46b46b46b46b46b46b46b46b46b46b46b46b46b46b46b46b46b46b46b46b46b54b54b46b46b46b46b46b46b46b46b46b46b46b46b46b46b46b46b46b46b46b46b46b46b46b46
	  b46b46b46b46b46b46b46b46b46b46b46b46b46b46b46b46b46b46b46b46b46b46b46b46b54b54b46b46b46b46b46b46b46b46b46b46b46b46b46b46b46b46b46b46b46b46b46b46b46b46
	  b46b46b46b46b46b46b46b46b46b46b46b46b46b46b46b46b46b46b46b46b46b46b46b46b54b54b46b46b46b46b46b46b46b46b46b46b46b46b46b46b46b46b46b46b46b46b46b46b46b46
	  b46b46b46b46b46b46b46b46b46b46b46b46b46b46b46b46b46b46b46b46b46b46b46b46b54b54b46b46b46b46b46b46b46b46b46b46b46b46b46b46b46b46b46b46b46b46b46b46b46b46
	  b08b08b08b08b08b08b08b08b08b08b08b08b08b08b08b08b08b08b08b08b11b11b11b11b11b11b11b11b11b11b08b08b08b08b08b08b08b08b08b08b08b08b08b08b08b08b08b08b08b08
	  b08b08b08b08b08b08b08b08b08b08b08b08b08b08b08b08b08b08b08b08b11b11b11b11b11b11b11b11b11b11b08b08b08b08b08b08b08b08b08b08b08b08b08b08b08b08b08b08b08b08
	  b08b08b08b08b08b08b08b08b08b08b08b08b08b08b08b08b08b08b08b08b11b11b11b11b30b30b11b11b11b11b08b08b08b08b08b08b08b08b08b08b08b08b08b08b08b08b08b08b08b08
	  b08b08b08b08b08b08b08b08b08b08b08b08b08b08b08b08b08b08b08b08b11b11b11b11b30b30b11b11b11b11b08b08b08b08b08b08b08b08b08b08b08b08b08b08b08b08b08b08b08b08
	  
warps = 48:24:hub.map:1280:300
	48:25:hub.map:1280:300
	49:24:hub.map:1280:300
	49:25:hub.map:1280:300
	0:2:island.map:896:1792
	0:3:island.map:896:1792

enemies = 40:Pirate
	  	  20:Magepirate
		  20:Brutepirate
		  1:Seadrake
		  
enemySpawn = 256:1024
			 1600:2240
	     	 1600:320
			 2688:1536
	     	 448:2368
			 2112:1536
	     	 2688:320