[level]
tileset = tiles32x32.bmp
map = a75a75a75a75a75a75a75a75a75a75a75a75a75a75a75a75a75a75a75a75a75a75a75a75a75a75a75a75a75a75a75a75a75a75a75a75a75a75a75a75a75a75a75a75a75a75a75a75a75a75
	  a75a75a75a75a75a75a75a75a75a75a75a75a75a75a75a75a75a75a75a75a75a75a75a75a75a75a75a75a75a75a75a75a75a75a75a75a75a75a75a75a75a75a75a75a75a75a75a75a75a75
	  a75a75a75a75a75a75a75a75a75a75a75a75a75a75a75a75a75a75a75a75a75a75a75a75a75a75a75a75a75a75a75a75a75a75a75a75a75a75a75a75a75a75a75a75a75a75a75a75a75a75
	  a75a75a75a75a75a75a75a75a75a75a75a75a75a75a75a75a75a75a75a75a75a75a75a75b30b30a75a75a75a75a75a75a75a75a75a75a75a75a75a75a75a75a75a75a75a75a75a75a75a75
	  a75a75a75a75a75a75a75a75a75a75a75a75a75a75a75a75a75a75a75a75b02b02b02b41b41b41b41b02b02b02a75a75a75a75a75a75a75a75a75a75a75a75a75a75a75a75a75a75a75a75
	  a75a75a75a75a75a75a75a75a75a75a75a75a75a75a75a75a75a75a75a75b02b02b02b41b41b41b41b02b02b02a75a75a75a75a75a75a75a75a75a75a75a75a75a75a75a75a75a75a75a75
	  a75a75a75a75a75a75a75a75a75a75a75a75a75a75a75a75a75a75a75a75b02b02b02b41b41b41b41b02b02b02a75a75a75a75a75a75a75a75a75a75a75a75a75a75a75a75a75a75a75a75
	  a75a75a75a75a75a75a75a75a75a75a75a75a75a75a75a75a75a75a75a75b02b02b02b41b41b41b41b02b02b02a75a75a75a75a75a75a75a75a75a75a75a75a75a75a75a75a75a75a75a75
	  a75a75a75a75a75a75a75a75a75a75a75a75a75a75a75a75a75a75a75a75b02b02b02b41b41b41b41b02b02b02a75a75a75a75a75a75a75a75a75a75a75a75a75a75a75a75a75a75a75a75
	  a75a75a75a75a75a75a75a75a75a75a75a75a75a75a75a75a75a75a75a75b02b02b02b41b41b41b41b02b02b02a75a75a75a75a75a75a75a75a75a75a75a75a75a75a75a75a75a75a75a75
	  a75a75a75a75a75a75a75a75a75a75a75a75a75a75a75a75a75a75a75a75b02b02b02b41b41b41b41b02b02b02a75a75a75a75a75a75a75a75a75a75a75a75a75a75a75a75a75a75a75a75
	  a75a75a75a75a75a75a75a75a75a75a75a75a75a75a75a75a75a75a75a75b02b02b02b41b41b41b41b02b02b02a75a75a75a75a75a75a75a75a75a75a75a75a75a75a75a75a75a75a75a75
	  a75a75a75a75a75a75a75a75a75a75a75a75a75a75a75a75a75a75a75a75b02b02b02b41b41b41b41b02b02b02a75a75a75a75a75a75a75a75a75a75a75a75a75a75a75a75a75a75a75a75
	  a75a75a75a75a75a75a75a75a75a75a75a75a75a75a75a75a75a75a75a75b02b02b02b41b41b41b41b02b02b02a75a75a75a75a75a75a75a75a75a75a75a75a75a75a75a75a75a75a75a75
	  a75a75a75a75a75a75a75a75a75a75a75a75a75a75a75a75a75a75a75a75b02b02b02b41b41b41b41b02b02b02a75a75a75a75a75a75a75a75a75a75a75a75a75a75a75a75a75a75a75a75
	  b02b02b41b41b41b41b41b41b41b41b02b02b41b41b41b41b41b41b41b41b02b02b02b41b41b41b41b02b02b02b41b41b41b41b41b41b41b41b41b41b41b41b41b41b41b41b41b41b02b02
	  b02b02b41b41b41b41b41b41b41b41b41b41b41b41b41b41b41b41b41b41b41b41b41b41b41b41b41b02b02b02b41b41b41b41b41b41b41b41b41b41b41b41b41b41b41b41b41b41b02b02
	  b02b02b41b41b41b41b41b41b41b41b41b41b41b41b41b41b41b41b41b41b41b41b41b41b41b41b41b02b02b02b41b41b41b41b41b41b41b41b41b41b41b41b41b41b41b41b41b41b02b02
	  b02b02b41b41b41b41b41b41b41b41b02b02b41b41b41b41b41b41b41b41b02b02b02b41b41b41b41b02b02b02b41b41b41b41b41b41b41b41b41b41b41b41b41b41b41b41b41b41b02b02
	  b02b02b41b41b41b41b41b41b41b41b02b02b02b02b02b02b02b02b41b41b02b02b02b02b02b02b02b02b02b02b41b41b41b41b41b41b41b41b41b41b41b41b41b41b41b41b41b41b02b02
	  b02b02b41b41b41b41b41b41b41b41b02b02b02b02b02b02b02b02b41b41b02b02b02b02b02b02b02b02b02b02b41b41b41b41b41b41b41b41b41b41b41b41b41b41b41b41b41b41b02b02
	  b02b02b41b41b41b41b41b41b41b41b41b41b41b41b41b41b02b02b41b41b02b02b41b41b41b02b02b02b02b02b41b41b41b41b41b41b41b41b41b41b41b41b41b41b41b41b41b41b02b02
	  b02b02b41b41b41b41b41b41b41b41b41b41b41b41b41b41b02b02b41b41b41b41b41b41b41b02b02b02b02b02b41b41b41b41b41b41b41b41b41b41b41b41b41b41b41b41b41b41b02b02
	  b02b02b41b41b41b41b41b41b41b41b41b41b41b41b41b41b02b02b41b41b41b41b41b41b41b02b02b02b02b02b02b02b02b41b41b02b02b02b02b02b02b02b02b41b41b02b02b02b02b02
	  b02b02b02b02b02b41b41b02b02b02b02b02b02b41b41b02b02b02b02b02b02b02b41b41b41b02b02b02b02b02b02b02b02b41b41b02b02b02b02b02b02b02b02b41b41b02b02b02b02b02
	  b02b02b02b02b02b41b41b02b02b02b02b02b02b41b41b02b02b02b02b02b02b02b41b41b41b02b02b02b02b02b41b41b41b41b41b41b41b41b02b02b41b41b41b41b41b41b41b41b02b02
	  b02b02b41b41b41b41b41b41b41b41b02b02b41b41b41b41b41b41b41b41b02b02b41b41b41b02b02b02b02b02b41b41b41b41b41b41b41b41b02b02b41b41b41b41b41b41b41b41b02b02
	  b02b02b41b41b41b41b41b41b41b41b02b02b41b41b41b41b41b41b41b41b02b02b41b41b41b02b02b02b02b02b41b41b41b41b41b41b41b41b02b02b41b41b41b41b41b41b41b41b02b02
	  b02b02b41b41b41b41b41b41b41b41b02b02b41b41b41b41b41b41b41b41b02b02b41b41b41b02b02b02b02b02b41b41b41b41b41b41b41b41b02b02b41b41b41b41b41b41b41b41b02b02
	  b02b02b41b41b41b41b41b41b41b41b02b02b41b41b41b41b41b41b41b41b02b02b41b41b41b02b02b02b02b02b41b41b41b41b41b41b41b41b02b02b41b41b41b41b41b41b41b41b02b02
	  b02b02b41b41b41b41b41b41b41b41b02b02b41b41b41b41b41b41b41b41b02b02b41b41b41b02b02b02b02b02b41b41b41b41b41b41b41b41b02b02b41b41b41b41b41b41b41b41b02b02
	  b02b02b41b41b41b41b41b41b41b41b02b02b41b41b41b41b41b41b41b41b02b02b41b41b41b41b41b41b02b02b41b41b41b41b41b41b41b41b02b02b41b41b41b41b41b41b41b41b02b02
	  b02b02b41b41b41b41b41b41b41b41b02b02b41b41b41b41b41b41b41b41b02b02b41b41b41b41b41b41b02b02b41b41b41b41b41b41b41b41b02b02b41b41b41b41b41b41b41b41b02b02
	  b02b02b41b41b41b41b41b41b41b41b02b02b41b41b41b41b41b41b41b41b02b02b41b41b41b41b41b41b02b02b41b41b41b41b41b41b41b41b02b02b02b02b02b41b41b02b02b02b02b02
	  b02b02b41b41b41b41b41b41b41b41b02b02b41b41b41b41b41b41b41b41b02b02b41b41b41b41b41b41b41b41b41b41b41b41b41b41b41b41b02b02b02b02b02b41b41b02b02b02b02b02
	  b02b02b41b41b41b41b41b41b41b41b02b02b41b41b41b41b41b41b41b41b02b02b41b41b41b41b41b41b41b41b41b41b41b41b41b41b41b41b02b02b41b41b41b41b41b41b41b41b02b02
	  b02b02b41b41b41b41b41b41b41b41b02b02b41b41b41b41b41b41b41b41b02b02b41b41b41b41b41b41b02b02b41b41b41b41b41b41b41b41b02b02b41b41b41b41b41b41b41b41b02b02
	  b02b02b41b41b41b41b41b02b02b02b02b02b41b41b41b41b41b41b41b41b02b02b41b41b41b41b41b41b02b02b41b41b41b41b41b41b41b41b02b02b41b41b41b41b41b41b41b41b02b02
	  b02b02b41b41b41b41b41b02b02b02b02b02b41b41b41b41b41b41b41b41b02b02b41b41b41b41b41b41b02b02b41b41b41b41b41b41b41b41b02b02b41b41b41b41b41b41b41b41b02b02
	  b02b02b41b41b41b41b41b02b02b41b41b41b41b41b41b41b41b41b41b41b02b02b02b02b02b02b02b02b02b02b41b41b41b41b41b41b41b41b02b02b41b41b41b41b41b41b41b41b02b02
	  b02b02b41b41b41b41b41b02b02b41b41b41b41b41b41b41b41b41b41b41b02b02b02b02b02b02b02b02b02b02b41b41b41b41b41b41b41b41b02b02b41b41b41b41b41b41b41b41b02b02
	  b02b41b41b41b41b41b41b02b02b41b41b41b41b41b41b41b41b41b41b41b02b02b41b41b41b41b41b41b02b02b41b41b41b41b41b41b41b41b02b02b41b41b41b41b41b41b41b41b02b02
	  b02b41b41b41b41b41b41b02b02b41b41b41b41b41b41b41b41b41b41b41b02b02b41b41b41b41b41b41b02b02b41b41b41b41b41b41b41b41b02b02b41b41b41b41b41b41b41b41b02b02
	  b02b41b41b41b02b02b02b02b02b02b02b02b02b02b02b02b41b41b02b02b02b02b41b41b41b41b41b41b02b02b02b02b02b02b02b02b02b02b02b02b41b41b41b41b41b41b41b41b02b02
	  b02b41b41b41b02b02b02b02b02b02b02b02b02b02b02b02b41b41b02b02b02b02b41b41b41b41b41b41b02b02b02b02b02b02b02b02b02b02b02b02b41b41b41b41b41b41b41b41b02b02
	  b02b41b41b41b02b02b41b41b41b41b41b41b41b41b41b41b41b41b41b41b02b02b41b41b41b41b41b41b41b41b41b41b41b41b41b41b41b41b02b02b41b41b41b41b41b41b41b41b02b02
	  b02b41b41b41b02b02b41b41b41b41b41b41b41b41b41b41b41b41b41b41b02b02b41b41b41b41b41b41b41b41b41b41b41b41b41b41b41b41b02b02b41b41b41b41b41b41b41b41b02b02
	  b02b41b41b41b02b02b41b41b41b41b41b41b41b41b41b41b41b41b41b41b41b41b41b41b41b41b41b41b41b41b41b41b41b41b41b41b41b41b41b41b41b41b41b41b41b41b41b41b02b02
	  b02b41b41b41b02b02b41b41b41b41b41b41b41b41b41b41b41b41b41b41b41b41b41b41b41b41b41b41b41b41b41b41b41b41b41b41b41b41b41b41b41b41b41b41b41b41b41b41b02b02
	  b02b41b41b41b02b02b41b41b41b41b41b41b41b41b41b41b41b41b41b41b02b02b41b41b41b41b41b41b41b41b41b41b41b41b41b41b41b41b02b02b41b41b41b41b41b41b41b41b02b02
	  b02b41b41b41b02b02b41b41b41b41b41b41b41b41b41b41b41b41b41b41b02b02b41b41b41b41b41b41b41b41b41b41b41b41b41b41b41b41b02b02b41b41b41b41b41b41b41b41b02b02
	  b02b41b41b41b02b02b41b41b41b41b41b41b41b41b41b41b41b02b02b02b02b02b02b02b02b02b02b02b02b02b02b02b02b02b41b41b02b02b02b02b02b02b02b41b41b02b02b02b02b02
	  b02b41b41b41b02b02b41b41b41b41b41b41b41b41b41b41b41b02b02b02b02b02b02b02b02b02b02b02b02b02b02b02b02b02b41b41b02b02b02b02b02b02b02b41b41b02b02b02b02b02
	  b02b41b41b41b02b02b41b41b41b41b41b41b41b41b41b41b41b02b02b41b41b41b41b41b41b41b41b41b41b02b02b41b41b41b41b41b41b41b02b02b41b41b41b41b41b41b41b41b02b02
	  b02b41b41b41b02b02b02b02b02b02b02b02b02b02b02b02b02b02b02b41b41b41b41b41b41b41b41b41b41b02b02b41b41b41b41b41b41b41b02b02b41b41b41b41b41b41b41b41b02b02
	  b02b41b41b41b02b02b02b02b02b02b02b02b02b02b02b02b02b02b02b41b41b41b41b41b41b41b41b41b41b02b02b41b41b41b41b41b41b41b02b02b41b41b41b41b41b41b41b41b02b02
	  b02b41b41b41b02b02b41b41b41b41b41b41b41b41b41b41b41b41b41b41b41b41b41b30b30b41b41b41b41b41b41b41b41b41b41b41b41b41b02b02b41b41b41b41b41b41b41b41b02b02
	  b02b41b41b41b02b02b41b41b41b41b41b41b41b41b41b41b41b41b41b41b41b41b41b30b30b41b41b41b41b41b41b41b41b41b41b41b41b41b02b02b41b41b41b41b41b41b41b41b02b02
	  b02b41b41b41b02b02b41b41b41b41b41b41b41b41b41b41b41b02b02b41b41b41b41b41b41b41b41b41b41b02b02b41b41b41b41b41b41b41b02b02b41b41b41b41b41b41b41b41b02b02
	  b02b41b41b41b02b02b41b41b41b41b41b41b41b41b41b41b41b02b02b41b41b41b41b41b41b41b41b41b41b02b02b41b41b41b41b41b41b41b02b02b41b41b41b41b41b41b41b41b02b02
	  b02b41b41b41b02b02b41b41b41b41b41b41b41b41b41b41b41b02b02b41b41b41b41b41b41b41b41b41b41b02b02b41b41b41b41b41b41b41b02b02b41b41b41b41b41b41b41b41b02b02
	  b02b41b41b41b02b02b41b41b41b41b41b41b41b41b41b41b41b02b02b02b02b02b41b41b41b41b02b02b02b02b02b02b02b02b02b02b02b02b02b02b41b41b41b41b41b41b41b41b02b02
	  b02b41b41b41b02b02b41b41b41b41b41b41b41b41b41b41b41b02b02b02b02b02b41b41b41b41b02b02b02b02b02b02b02b02b02b02b02b02b02b02b41b41b41b41b41b41b41b41b02b02
	  b02b41b41b41b41b41b41b41b41b41b41b41b41b41b41b41b41b41b41b41b02b02b41b41b41b41b41b41b41b41b41b41b41b41b41b41b41b41b02b02b41b41b41b41b41b41b41b41b02b02
	  b02b41b41b41b41b41b41b41b41b41b41b41b41b41b41b41b41b41b41b41b02b02b41b41b41b41b41b41b41b41b41b41b41b41b41b41b41b41b41b41b41b41b41b41b41b41b41b41b02b02
	  b02b41b41b41b02b02b41b41b41b41b41b41b41b41b41b41b41b41b41b41b02b02b41b41b41b41b41b41b41b41b41b41b41b41b41b41b41b41b41b41b41b41b41b41b41b41b41b41b02b02
	  b02b41b41b41b02b02b02b02b02b02b02b02b02b02b02b02b02b02b02b02b02b02b41b41b41b41b41b41b41b41b41b41b41b41b41b41b41b41b02b02b41b41b41b41b41b41b41b41b02b02
	  b02b41b41b41b02b02b02b02b02b02b02b02b02b02b02b02b02b02b02b02b02b02b02b02b02b02b02b02b02b02b02b02b02b02b02b02b02b02b02b02b41b41b41b41b41b41b41b41b02b02
	  b02b02b02b02b02b02b02b02b02b02b02b02b02b02b02b02b02b02b02b02b02b02b02b02b02b02b02b02b02b02b02b02b02b02b02b02b02b02b02b02b41b41b41b41b41b41b41b41b02b02
	  b02b02b02b02b02b02b02b02b02b02b02b02b02b02b02b02b02b02b02b02b02b02b02b02b02b02b02b02b02b02b02b02b02b02b02b02b02b02b02b02b02b02b02b02b02b02b02b02b02b02
	  
warps = 56:23:hub.map:768:300
		56:24:hub.map:768:300
		57:23:hub.map:768:300
		57:24:hub.map:768:300
		3:24:volcaniccave.map:1280:1696
		3:25:volcaniccave.map:1280:1696

enemies = 40:Goblin
	  	  20:Orc
		  20:Fireslime
		  2:Dragonkin
		  
enemySpawn = 768:3840
			 2816:3840
	     	 1024:2240
			 1600:2240
	     	 384:2048
			 2816:1792
	     	 448:1152
			 2496:1152